Pièce : UW_A08
taille : 48x35
###################/#######/####################
################################################
################################################
################################################
################################################
###############/###############/################
################/#############/#################
################################################
################################################
################################################
################/#############/#################
###############/###############/################
################################################
################################################
################################################
################################################
###################/#######/####################
##################/#########/###################
#####//##########/###########/##########//######
################/#############/#################
################################################
################################################
################################################
################################################
################################################
##########...#################...###...#########
##...#####...........##......................###
#..............................................#
#.................######...........#####.......#
################################################
##=#####.########################.##########=###
########.########################.##############
########..........................##############
################################################
################################################
(1,27),(1,29)|(2,26),(2,27)|(2,30),(2,31)|(3,30),(3,31)|(5,26),(5,27)|(8,30),(8,33)|(9,30),(9,32)|(10,25),(10,27)|(13,25),(13,26)|(18,28),(18,29)|(21,26),(21,27)|(23,26),(23,27)|(24,28),(24,29)|(30,25),(30,26)|(33,25),(33,26)|(33,30),(33,32)|(34,30),(34,33)|(35,28),(35,29)|(36,25),(36,26)|(39,25),(39,26)|(40,28),(40,29)|(44,30),(44,31)|(45,26),(45,27)|(45,30),(45,31)|(47,27),(47,29)|
(10,25),(13,25)|(30,25),(33,25)|(36,25),(39,25)|(2,26),(5,26)|(13,26),(21,26)|(23,26),(30,26)|(33,26),(36,26)|(39,26),(45,26)|(1,27),(2,27)|(5,27),(10,27)|(21,27),(23,27)|(45,27),(47,27)|(18,28),(24,28)|(35,28),(40,28)|(1,29),(18,29)|(24,29),(35,29)|(40,29),(47,29)|(2,30),(3,30)|(8,30),(9,30)|(33,30),(34,30)|(44,30),(45,30)|(2,31),(3,31)|(44,31),(45,31)|(9,32),(33,32)|(8,33),(34,33)|(5,18),(6,19)|(40,18),(41,19)|(6,19),(7,18)|(15,6),(16,5)|(15,12),(17,10)|(16,7),(17,6)|(16,20),(20,16)|(19,1),(20,0)|(27,1),(28,0)|(27,17),(28,16)|(28,18),(29,17)|(29,19),(30,18)|(30,7),(32,5)|(30,11),(31,10)|(30,20),(31,19)|(31,12),(32,11)|(41,19),(42,18)|