Pièce : UW_A06
taille : 48x35
################################################
################################################
##################=#############################
##################.#############################
##################.#############################
##=.......########.#############################
#########.########.##########.................=#
#########.########.##########.####.#############
#########.########.##########.####.#############
#########.########.##########.####.#############
#########.########.##########.####.#############
###............................###.....#########
##...........##................####......#######
#...........####.............######...........=#
################################################
###=#######################################=####
################################################
################################################
###########/.|.####..|.....|..####.|../#########
##########/|.|.####..|........####.|.../########
##########.|.|...##..|..........##.|....########
##########.|.|..................################
##########...|..................################
##########...|..........................########
##########...|..........................########
##########..............................########
##########..............................########
##########..............................########
##########..............................########
##########..............................########
##########..............................########
##########..............................########
##########..............................########
##########..............................########
##########..............................########
(1,13),(1,14)|(2,5),(2,6)|(2,12),(2,13)|(3,11),(3,12)|(3,15),(3,16)|(4,15),(4,16)|(9,6),(9,11)|(10,5),(10,11)|(12,13),(12,14)|(13,12),(13,13)|(15,12),(15,13)|(15,18),(15,20)|(16,13),(16,14)|(17,20),(17,21)|(18,2),(18,11)|(19,2),(19,11)|(19,18),(19,21)|(29,6),(29,11)|(29,13),(29,14)|(30,7),(30,11)|(30,18),(30,20)|(31,11),(31,13)|(32,20),(32,23)|(34,7),(34,12)|(34,18),(34,21)|(35,7),(35,11)|(35,12),(35,14)|(39,11),(39,12)|(40,21),(40,23)|(41,12),(41,13)|(43,15),(43,16)|(44,15),(44,16)|(47,6),(47,7)|(47,13),(47,14)|
(18,18),(19,2)|(2,2),(10,5)|(2,2),(9,6)|(29,29),(47,6)|(30,30),(34,7)|(35,35),(47,7)|(3,3),(9,11)|(10,10),(18,11)|(19,19),(29,11)|(30,30),(31,11)|(35,35),(39,11)|(2,2),(3,12)|(13,13),(15,12)|(34,34),(35,12)|(39,39),(41,12)|(1,1),(2,13)|(12,12),(13,13)|(15,15),(16,13)|(29,29),(31,13)|(41,41),(47,13)|(1,1),(12,14)|(16,16),(29,14)|(35,35),(47,14)|(3,3),(4,15)|(43,43),(44,15)|(3,3),(4,16)|(43,43),(44,16)|(15,15),(19,18)|(30,30),(34,18)|(15,15),(17,20)|(30,30),(32,20)|(17,17),(19,21)|(34,34),(40,21)|(32,32),(40,23)|(10,10),(40,35)|
(38,18),(40,20)|
(10,20),(12,18)|
(11.5,19),(11.5,22)|(13.5,18),(13.5,25)|(21.5,18),(21.5,21)|(27.5,18),(27.5,19)|(35.5,18),(35.5,21)|

end file : UW_A06