Pièce : UW_A05
taille : 48x35
################################################
################################################
################################################
################################################
####...............................#############
###.........................................####
##............##............................####
#########...#####...........................####
###=#=#=###############################.....####
#######################################.....####
########################################....####
########################################----####
########################################....####
#######################################.....####
#######################################.....####
#######################################--.--####
#######################################.....####
#######################################.....####
#######################################.....####
#######################################-----####
#######################################.....####
#######################################.....####
#######################################.....####
#######################################-..--####
#######################################.....####
#######################################.....####
#######################################-----####
#######################################.....####
#######################################.....####
#######################################....#####
################################################
########################################=#=#####
################################################
################################################
################################################
2,6|2,7|3,5|3,6|3,8|3,9|4,4|4,5|4,8|4,9|5,8|5,9|6,8|6,9|7,8|7,9|8,8|8,9|9,7|9,8|12,7|12,8|14,6|14,7|16,6|16,7|17,7|17,8|35,4|35,5|39,8|39,10|39,13|39,30|40,10|40,13|40,31|40,32|41,31|41,32|42,31|42,32|43,29|43,30|43,31|43,32|44,5|44,29|
(2,6),(2,7)|(3,5),(3,6)|(3,8),(3,9)|(4,4),(4,5)|(4,8),(4,9)|(5,8),(5,9)|(6,8),(6,9)|(7,8),(7,9)|(8,8),(8,9)|(9,7),(9,8)|(12,7),(12,8)|(14,6),(14,7)|(16,6),(16,7)|(17,7),(17,8)|(35,4),(35,5)|(39,8),(39,10)|(39,13),(39,30)|(40,10),(40,13)|(40,31),(40,32)|(41,31),(41,32)|(42,31),(42,32)|(43,29),(43,30)|(43,31),(43,32)|(44,5),(44,29)|
(4,4),(35,4)|(3,5),(4,5)|(35,5),(44,5)|(2,6),(3,6)|(14,6),(16,6)|(2,7),(9,7)|(12,7),(14,7)|(16,7),(17,7)|(3,8),(4,8)|(5,8),(6,8)|(7,8),(8,8)|(9,8),(12,8)|(17,8),(39,8)|(3,9),(4,9)|(5,9),(6,9)|(7,9),(8,9)|(39,10),(40,10)|(39,13),(40,13)|(43,29),(44,29)|(39,30),(43,30)|(40,31),(41,31)|(42,31),(43,31)|(40,32),(41,32)|(42,32),(43,32)|