Pièce : UW_A02
taille : 59x35
......................#####################################
....................../####################################
............................................###############
............................................###############
...................................................########
...................................................########
....................................................=######
...................................................########
............................|.................#############
............................|.................#############
............................|..............---#############
............................|.....####........#############
............................|.....####........#############
............................|.....####......###############
............................###..######...#################
...##############---+-+---#################################
...##############...|.|...#################################
...##############---+-+---#################################
........|.|.........|.|.........|.|.........|.|....########
........|.|.........|.|.........|.|.........|.|....########
........|.|.........|.|.........|.|.........|.|....########
........|.|.........|...........|.|.........|.|.....=######
........|.|.........|...........|.|.........|.|....########
........|.|.........|...........|.|.........|.|....########
...##############---+-+---#################################
...##############...|.|...#####=###########################
...##############---+-+---#################################
.............................####.............#############
.............................##############################
.............................##############################
.............................##############################
.............................##############################
...............................#...#..........#############
................................................#..########
...................................................########
(3,15),(3,18)|(3,24),(3,27)|(17,15),(17,18)|(17,24),(17,27)|(26,15),(26,18)|(26,24),(26,27)|(28,14),(28,15)|(29,27),(29,32)|(31,14),(31,15)|(31,25),(31,26)|(31,32),(31,33)|(32,25),(32,26)|(32,32),(32,33)|(33,14),(33,15)|(33,27),(33,28)|(34,11),(34,14)|(35,32),(35,33)|(36,32),(36,33)|(38,11),(38,14)|(39,14),(39,15)|(42,14),(42,15)|(44,2),(44,4)|(44,13),(44,14)|(46,8),(46,13)|(46,27),(46,28)|(46,32),(46,33)|(48,33),(48,34)|(49,33),(49,34)|(51,4),(51,6)|(51,7),(51,8)|(51,18),(51,21)|(51,22),(51,24)|(51,33),(51,35)|(53,6),(53,7)|(53,21),(53,22)|
(44,44),(51,4)|(51,51),(53,6)|(51,51),(53,7)|(46,46),(51,8)|(34,34),(38,11)|(44,44),(46,13)|(28,28),(31,14)|(33,33),(34,14)|(38,38),(39,14)|(42,42),(44,14)|(3,3),(17,15)|(26,26),(28,15)|(31,31),(33,15)|(39,39),(42,15)|(3,3),(17,18)|(26,26),(51,18)|(51,51),(53,21)|(51,51),(53,22)|(3,3),(17,24)|(26,26),(51,24)|(31,31),(32,25)|(31,31),(32,26)|(3,3),(17,27)|(26,26),(29,27)|(33,33),(46,27)|(33,33),(46,28)|(29,29),(31,32)|(32,32),(35,32)|(36,36),(46,32)|(31,31),(32,33)|(35,35),(36,33)|(46,46),(48,33)|(49,49),(51,33)|(48,48),(49,34)|
(22,1),(23,2)|

(8.5,18),(8.5,24)|(10.5,18),(10.5,24)|(22.5,21),(28.5,8)|(28.5,14),(32.5,18)|(32.5,24),(34.5,18)|(34.5,24),(44.5,18)|(44.5,24),(46.5,18)|
(17,15.5),(17,17.5)|(17,24.5),(17,26.5)|(26,15.5),(26,17.5)|(26,24.5),(26,26.5)|(43,10.5),(46,10.5)|
end file : UW_A02