Pièce : UW_A10
taille : 48x35
################################################
################################################
################################################
################################################
################################################
################################################
################################################
################################################
################################################
###...........................................##
###...........................................##
###...........................................##
###...........................................##
####..........................................##
#####.........#####......................###..##
#######HH#################################=#####
#######..#######################################
#######..#######################################
#######..#######################################
#######--#######################################
#######..#######################################
#######..###########/#############/#############
#####/#..#/##########/###########/##########/###
#######--#############/#########/###############
#######..##############/#######/################
#######..#######################################
#######..#######################################
#######--#######################################
#######..#######################################
#######..##########/###############/############
#######..###########/#############/#############
################################################
#######=########################################
################################################
####################/#############/#############
3,9|3,13|4,13|4,14|5,14|5,15|5,23|6,22|7,31|7,32|7,33|8,32|8,33|9,31|10,23|11,22|14,14|14,15|19,14|19,15|19,30|20,22|20,29|20,31|20,34|21,21|21,23|21,30|21,35|22,22|22,24|23,23|23,25|24,24|31,25|34,31|34,34|35,21|35,35|36,29|41,14|41,15|42,15|42,16|43,15|43,16|44,14|44,15|44,23|45,22|46,9|46,15|
(3,9),(3,13)|(4,13),(4,14)|(5,14),(5,15)|(5,23),(6,22)|(7,31),(7,32)|(7,33),(8,32)|(8,33),(9,31)|(10,23),(11,22)|(14,14),(14,15)|(19,14),(19,15)|(19,30),(20,22)|(20,29),(20,31)|(20,34),(21,21)|(21,23),(21,30)|(21,35),(22,22)|(22,24),(23,23)|(23,25),(24,24)|(31,25),(34,31)|(34,34),(35,21)|(35,35),(36,29)|(41,14),(41,15)|(42,15),(42,16)|(43,15),(43,16)|(44,14),(44,15)|(44,23),(45,22)|(46,9),(46,15)|
(3,9),(46,9)|(3,13),(4,13)|(4,14),(5,14)|(14,14),(19,14)|(41,14),(44,14)|(5,15),(14,15)|(19,15),(41,15)|(42,15),(43,15)|(44,15),(46,15)|(42,16),(43,16)|(21,21),(35,21)|(6,22),(11,22)|(20,22),(22,22)|(45,22),(5,23)|(10,23),(21,23)|(23,23),(44,23)|(22,24),(24,24)|(23,25),(31,25)|(20,29),(36,29)|(19,30),(21,30)|(7,31),(9,31)|(20,31),(34,31)|(7,32),(8,32)|(7,33),(8,33)|(20,34),(34,34)|(21,35),(35,35)|