Pièce : UW_A02
taille : 59x35
......................#####################################
....................../####################################
............................................###############
............................................###############
...................................................########
...................................................########
....................................................=######
...................................................########
............................|.................#############
............................|.................#############
............................|..............---#############
............................|.....####........#############
............................|.....####........#############
............................|.....####......###############
............................###..######...#################
...##############---+-+---#################################
...##############...|.|...#################################
...##############---+-+---#################################
........|.|.........|.|.........|.|.........|.|....########
........|.|.........|.|.........|.|.........|.|....########
........|.|.........|.|.........|.|.........|.|....########
........|.|.........|...........|.|.........|.|.....=######
........|.|.........|...........|.|.........|.|....########
........|.|.........|...........|.|.........|.|....########
...##############---+-+---#################################
...##############...|.|...#####=###########################
...##############---+-+---#################################
.............................####.............#############
.............................##############################
.............................##############################
.............................##############################
.............................##############################
...............................#...#..........#############
................................................#..########
...................................................########
(3,15),(3,18)|(3,24),(3,27)|(22,0),(28,15)|(29,27),(29,32)|(31,14),(31,15)|(31,25),(31,26)|(31,32),(31,33)|(32,25),(32,26)|(32,32),(32,33)|(33,14),(33,15)|(33,27),(33,28)|(34,11),(34,14)|(35,32),(35,33)|(36,32),(36,33)|(38,11),(38,14)|(39,14),(39,15)|(42,14),(42,15)|(44,2),(44,4)|(44,13),(44,14)|(46,8),(46,13)|(46,27),(46,28)|(46,32),(46,33)|(48,33),(48,34)|(49,33),(49,34)|(51,4),(51,6)|(51,7),(51,8)|(51,18),(51,21)|(51,22),(51,24)|(51,33),(51,35)|(53,6),(53,7)|(53,21),(53,22)|
(22,0),(44,2)|(44,4),(51,4)|(51,6),(53,6)|(51,7),(53,7)|(46,8),(51,8)|(34,11),(38,11)|(44,13),(46,13)|(31,14),(33,14)|(34,14),(38,14)|(39,14),(42,14)|(44,14),(3,15)|(28,15),(31,15)|(33,15),(39,15)|(42,15),(3,18)|(51,18),(51,21)|(53,21),(51,22)|(53,22),(3,24)|(51,24),(31,25)|(32,25),(31,26)|(32,26),(3,27)|(29,27),(33,27)|(46,27),(33,28)|(46,28),(29,32)|(31,32),(32,32)|(35,32),(36,32)|(46,32),(31,33)|(32,33),(35,33)|(36,33),(46,33)|(48,33),(49,33)|(51,33),(48,34)|(49,34),(51,35)|
(22,1),(23,2)|

