Pièce : UW_C01
taille : 152x35
########################################################################################################################################################
########################################################################################################################################################
########################################################################################################################################################
########################################################################################################################################################
########################################################################################################################################################
################=##=##################=##################=#################=###############=#################=##=###############=##=##############=#####
##/.........../#|##|#/.........../####|#/.........../####|#/........../####|#/.........../#|####/........../#|##|#/.........../#|##|#/........../#|####/
|...............|..|...............|..|...............|..|..............|..|...............|..|..............|..|...............|..|..............|..|..
|...............|..|...............|..|...............|..|..............|..|...............|..|..............|..|...............|..|..............|..|..
|...............|..|...............|..|...............|..|..............|..|...............|..|..............|..|...............|..|..............|..|..
|..................|...............|..|...............|..|..............|..|...............|..|..............|..|...............|..|..............|..|..
|..................|...............|..|...............|..|..............|..|...............|..|..............|..|...............|..|..............|..|..
|..................|...............|..|...............|..|..............|..|...............|..|..............|..|...............|.###.............|..|..
|..................|..................|...............|..|..............|..|...............|..|..............|..|..............#H#################H####.
|..................|..................|...............|..|.................|...............|..|..............|..|..............#|#################|####.
|...............|..|..................|...............|..|.................|...............|..|...........######H###...........#|#################|####.
|...............|..|..................|.............##H############........|...............|..|...........######|###...........#|#################|####.
|...............|..|...............|..|.............##|######=#####........|..................|...........######|###............|..|..............|..|..
................|..|...............|..|.............##|############........|..................|...........######|###............|.................|.....
................|..|...............|..|.............##|############........|..................|..............|..|...............|.................|.....
................|..|...............|..|...............|....................|..................|..............|..|...............|.................|.....
................|..|.......###.....|..|...............|....................|..................|..............|..|...............|..|....................
..............#####################H##H###............|....................|.................................|..|...............|..|....................
..............#######=#############=##|###............|....................|.................................|..|...............|..|....................
..............########################|###............|....................|.................................|..|...............|..|............##......
..............########################|###...........#H###.................|.............................../######/.........../######/.........####.....
......................................|..............###=#.................|...............................########################################.....
......................................|..............#####..............................................###########################################.....
......................................|..............#####..............................................##########################################......
......................................|.............................................../##############################################################...
...................................#####..............................................###############################################################...
...................................#=###..............................................###############################################################...
...................................#####..............................................###############################################################...
...................................#####..............................................############################################################......
......................................................................................############################################################......
