Piece : UW_C03
148x44
2213x-305
##################################################################################################/###############/##################/##############
###################################################################################################/#############/####################/#############
####################################################################################################################################################
#################..|.............|.......########...################################################################################################
####=##=#########..|.............|........=######...################################################################################################
../#|##|#/....|....|......#######################....########=...|...............|.....=###########/#############/####################/#############
....|..|......|....|......#=#=###################....#############################################/###############/##################/##############
....|..|......|....|......#######################....###############################################################################################
....|..|......|....|......#######################....###############################################################################################
....|..|......|...........#####..#...................###############################################################################################
....|..|......|..................|...............................#...............|.....#############################################################
..########.......................................................|......................##############/#######/##########################/#######/##
.###=##=##.......................................................|......................#############/#########/########################/#########/#
..########..............................................................................############/###########/##########//##########/###########/
.#########.............................................................................############/#############/####################/#############
....|..|...........................................................................#################################################################
....|...............................................................................=###############################################################
....|.........................................###.....................###..........#################################################################
.....................--+-###########################################################################################################################
.......................|.|##########################################################################################################################
...................----+-+-#########################################################################################################################
.......................|.|....................|.|.....................|.|.....................|.|.....................|.|.....................######
.......................|.|....................|.|.....................|.|.....................|.|.....................|.|.....................######
.......................|......................|.|.....................|.|.....................|.|.....................|.|.....................######
.......................|........................|.....................|.|.....................|.|.....................|.|......................=####
.......................|........................|.....................|.|.....................|.|.....................|.|.....................######
.......................|.|....................###.....................|.|.....................|.|....................####.....................######
..................-----+-+-#########################################################################################################################
.......................|.|##########################################################################################################################
.....................--+-###########################################################################################################################
...................................#..........###.....................###.............##############################################################
......................................................................................##############################################################
......................................................................................##############################################################
........................................................................................###########/#############/####################/#############
........................................................................................./##########/###########/##########//##########/###########/
.........................................................................................############/#########/########################/#########/#
.........................................................................................#############/#######/##########################/#######/##
.........................................................................................###########################################################
.........................................................................................###########################################################
.........................................................................................###########################################################
.........................................................................................###########################################################
.........................................................................................#########/###############/##################/##############
.........................................................................................##########/#############/####################/#############
.........................................................................................###########################################################
(1,12),(1,13)|(1,14),(1,15)|(2,11),(2,12)|(2,13),(2,14)|(4,4),(4,6)|(4,12),(4,13)|(5,4),(5,6)|(5,12),(5,13)|(7,4),(7,6)|(7,12),(7,13)|(8,4),(8,6)|(8,12),(8,13)|(10,11),(10,15)|(17,3),(17,5)|(25,18),(25,19)|(25,29),(25,30)|(26,5),(26,10)|(26,19),(26,20)|(26,28),(26,29)|(27,6),(27,7)|(27,20),(27,21)|(27,27),(27,28)|(28,6),(28,7)|(29,6),(29,7)|(30,6),(30,7)|(31,9),(31,10)|(33,9),(33,10)|(34,9),(34,10)|(35,30),(35,31)|(36,30),(36,31)|(41,3),(41,4)|(43,4),(43,5)|(46,17),(46,18)|(46,26),(46,27)|(46,30),(46,31)|(49,3),(49,9)|(49,17),(49,18)|(49,26),(49,27)|(49,30),(49,31)|(52,3),(52,5)|(53,5),(53,10)|(61,5),(61,6)|(65,10),(65,11)|(66,10),(66,11)|(70,17),(70,18)|(70,30),(70,31)|(73,17),(73,18)|(73,30),(73,31)|(83,15),(83,16)|(83,17),(83,18)|(85,16),(85,17)|(86,30),(86,33)|(87,10),(87,11)|(87,14),(87,15)|(88,5),(88,6)|(88,11),(88,14)|(88,33),(88,34)|(89,35),(89,44)|(117,26),(117,27)|(121,26),(121,27)|(142,21),(142,24)|(142,25),(142,27)|(144,24),(144,25)|(148,13),(148,14)|(148,34),(148,35)|
(98,0),(99,0)|(114,0),(115,0)|(133,0),(134,0)|(17,3),(41,3)|(49,3),(52,3)|(4,4),(5,4)|(7,4),(8,4)|(41,4),(43,4)|(0,5),(2,5)|(10,5),(17,5)|(26,5),(43,5)|(52,5),(53,5)|(61,5),(88,5)|(3,6),(4,6)|(5,6),(7,6)|(8,6),(9,6)|(27,6),(28,6)|(29,6),(30,6)|(61,6),(88,6)|(27,7),(28,7)|(29,7),(30,7)|(31,9),(33,9)|(34,9),(49,9)|(26,10),(31,10)|(33,10),(34,10)|(53,10),(65,10)|(66,10),(87,10)|(2,11),(10,11)|(65,11),(66,11)|(87,11),(88,11)|(1,12),(2,12)|(4,12),(5,12)|(7,12),(8,12)|(1,13),(2,13)|(4,13),(5,13)|(7,13),(8,13)|(1,14),(2,14)|(87,14),(88,14)|(1,15),(10,15)|(83,15),(87,15)|(83,16),(85,16)|(46,17),(49,17)|(70,17),(73,17)|(83,17),(85,17)|(25,18),(46,18)|(49,18),(70,18)|(73,18),(83,18)|(25,19),(26,19)|(26,20),(27,20)|(27,21),(142,21)|(142,24),(144,24)|(142,25),(144,25)|(46,26),(49,26)|(117,26),(121,26)|(27,27),(46,27)|(49,27),(117,27)|(121,27),(142,27)|(26,28),(27,28)|(25,29),(26,29)|(25,30),(35,30)|(36,30),(46,30)|(49,30),(70,30)|(73,30),(86,30)|(35,31),(36,31)|(46,31),(49,31)|(70,31),(73,31)|(86,33),(88,33)|(88,34),(89,34)|
(2,5),(3,6)|
(9,6),(10,5)|
(4.5,5),(4.5,11)|(4.5,15),(4.5,18)|(7.5,5),(7.5,11)|(7.5,15),(7.5,16)|(14.5,5),(14.5,11)|(19.5,3),(19.5,9)|(23.5,18),(23.5,30)|(25.5,19),(25.5,23)|(25.5,26),(25.5,29)|(33.5,3),(33.5,5)|(33.5,10),(33.5,11)|(46.5,21),(46.5,24)|(48.5,21),(48.5,26)|(65.5,5),(65.5,6)|(65.5,11),(65.5,13)|(70.5,21),(70.5,27)|(72.5,21),(72.5,27)|(81.5,5),(81.5,6)|(81.5,10),(81.5,11)|(94.5,21),(94.5,27)|(96.5,21),(96.5,27)|(118.5,21),(118.5,26)|(120.5,21),(120.5,26)|
(21,18.5),(25,18.5)|(19,20.5),(27,20.5)|(18,27.5),(27,27.5)|(21,29.5),(25,29.5)|
end file : UW_C03