Pièce : UW_D06
taille : 104x78
########################################################################################################
########################################################################################################
########################################################################################################
########...#..###################...#..###########.###..###...###################################.######
#######..........#############...........#########.###..###...###....###......###......###....###.######
######............###########.............########.###..###...###....###......###......###........######
######............##########..............########..|...###....|......|.......###.......|.........######
######...........############............#########..|...###....|......|.......###.......|...........####
######............##########..............########..|...###...........|........|........|...........####
######............##########..............########..|....|............|........|........|...........####
#######...........###########.............########.......|............|........|........|...........####
######...........###########..............########.......|............|........|.......###..........####
######............##########...............#.............|............|........|.......###...........=##
######............##########.............................|............|........|.......###..........####
######..............######...............................|............|........|........|...........####
######...............##.|................................|...........###.......|........|.........######
#######..............#..|................................|...........###.......|........|.........######
#####=...............|..|............................................###.......|........|.........######
#######..............|..|.............................................|........|........|.........######
######...............|..|.............................................|........|........|.........######
######..................|.............................................|........|........|.........######
######..................#......................................................|........|.........######
######..................#......................................................|........|.........######
##......................|.......................#.............................###.......|.........######
##..####................|...............######################................###.......|.........######
##--####................|...............######.###############................###.......|.........######
##..##..................|.................####.###############.................|........|.........######
##..##..................|.................####.###############.................|........|.........######
##--##..................|.................####.###############.................|........|.........######
##..##....................................##............................................|.........######
##..##....................................##.#################..........................|.........######
##--##....................................##.#################.........................###........######
##..##...............|....................##.#################.........................###........######
##..##...............|....................##.#################.........................###........######
##--##...............|....................##.#################..........................|.........######
##..##...............|....................##.#################..........................|.........######
##..##...............|....................##.#################..........................|.........######
##--##...............|....................##.#################....................................######
##..##...............|....................##.#################....................................######
##..##...............|....................##.#################....................................######
##--##...............|....................##.#################....................................######
##..##...............|..|.................##.#################....................................######
##..##.......|.......|..|.................##.#################....................................######
##...........|.......|..|...................................##....................................######
######.......|.......|..|...............######.###########..##....................................######
######......###......|..|...............######.###########--##....................................######
######......###......|..|.........|.....######.###########..##....................................######
#...........###......|..|.........|.........##.###########..##....................................######
#............|.......|..|.........|.........##.###########--##....................................######
#............|.......|..|.........|.........##.###########..##....................................######
#............|.......|..|........###........##.###########..##....................................######
#............|.......|..|........###........##.###########--##....................................######
#............|.......|..|........###........##.###########..##....................................######
#.......|....|.......|..|.........|.........##.###########..##...................................#######
#.......|....|.......|..|.........|.........##.###########--##...................................#######
#.......|....|.......|..|.........|............###########..##...................................#######
#......###...|.......#..#.........|.......################..##....................................######
#......###...|....##########......|.......################--##....................................######
#......###...|....##########......|.......################..##....................................######
#.......|....|....##########......|....|..################..##....................................######
#.......|....|....##########......|....|..################--##....................................######
#.......|....|....##########......|....|..################..##....................................######
#.......|...###...##########......|....|..################..##....................................######
#.......|...###...##########.....###...|..################--##....................................######
#.###...|...###...##########.....###...|..################..##....................................######
#.#=#...|...###...##########.....###..###.################..##....................................######
#.###..###..###.################.###..###.################.........................................=####
#.###..###..########################..###.####################....................................######
################################################################..................######........########
################################################################----#-.....-#-----######--------########
################################################################......................##........########
##############################################################........................##..........######
##############################################################....................................######
##############################################################....................................######
##############################################################...................................#######
###############################################################...................................######
##############################################################....................................######
##############################################################....................................######
1,47|1,68|2,23|2,44|2,64|2,68|3,65|3,66|4,24|4,43|4,65|4,66|5,17|5,18|5,64|5,68|6,5|6,10|6,11|6,16|6,19|6,23|6,26|6,43|6,44|6,47|7,4|7,5|7,10|7,11|7,16|7,17|7,18|7,19|7,56|7,59|7,66|7,68|8,3|8,4|8,24|8,26|10,56|10,59|10,66|10,68|11,3|11,4|12,3|12,4|12,45|12,48|12,62|12,68|14,3|14,4|15,45|15,48|15,62|15,67|16,66|16,67|17,4|17,5|17,7|17,8|17,11|17,12|18,5|18,7|18,8|18,11|18,12|18,14|18,57|18,66|20,14|20,15|21,15|21,57|22,16|22,57|23,15|23,16|24,57|25,57|26,14|26,15|28,6|28,7|28,8|28,10|28,11|28,14|28,57|28,66|29,5|29,6|29,7|29,8|29,10|29,11|30,4|30,5|32,66|32,67|33,3|33,4|33,50|33,53|33,63|33,67|36,3|36,4|36,50|36,53|36,63|36,68|37,3|37,4|38,65|38,68|39,3|39,4|40,24|40,26|40,44|40,47|41,4|41,5|41,7|41,8|41,65|41,68|42,5|42,7|42,8|42,12|42,26|42,43|42,56|42,68|43,12|43,13|44,12|44,13|44,29|44,43|44,47|44,55|45,30|45,43|46,25|46,29|46,44|46,55|47,25|47,29|47,44|47,56|48,23|48,24|49,23|49,24|50,3|50,12|51,3|51,6|54,3|54,6|56,3|56,9|58,44|58,67|59,3|59,9|60,43|60,66|62,3|62,6|62,24|62,29|62,30|62,66|62,67|62,68|62,71|62,75|62,76|62,78|63,75|63,76|64,68|64,71|65,4|65,6|69,4|69,6|69,15|69,18|72,4|72,6|72,15|72,18|78,4|78,8|78,23|78,26|81,4|81,8|81,23|81,26|82,68|86,70|86,72|87,4|87,6|87,11|87,14|87,31|87,34|88,68|88,72|90,4|90,6|90,11|90,14|90,31|90,34|94,4|94,5|96,68|96,71|97,3|97,5|97,53|97,56|97,74|97,75|98,3|98,7|98,15|98,53|98,56|98,66|98,67|98,68|98,71|98,74|98,75|98,78|100,7|100,12|100,13|100,15|100,66|100,67|102,12|102,13|
(1,47),(1,68)|(2,23),(2,44)|(2,64),(2,68)|(3,65),(3,66)|(4,24),(4,43)|(4,65),(4,66)|(5,17),(5,18)|(5,64),(5,68)|(6,5),(6,10)|(6,11),(6,16)|(6,19),(6,23)|(6,26),(6,43)|(6,44),(6,47)|(7,4),(7,5)|(7,10),(7,11)|(7,16),(7,17)|(7,18),(7,19)|(7,56),(7,59)|(7,66),(7,68)|(8,3),(8,4)|(8,24),(8,26)|(10,56),(10,59)|(10,66),(10,68)|(11,3),(11,4)|(12,3),(12,4)|(12,45),(12,48)|(12,62),(12,68)|(14,3),(14,4)|(15,45),(15,48)|(15,62),(15,67)|(16,66),(16,67)|(17,4),(17,5)|(17,7),(17,8)|(17,11),(17,12)|(18,5),(18,7)|(18,8),(18,11)|(18,12),(18,14)|(18,57),(18,66)|(20,14),(20,15)|(21,15),(21,57)|(22,16),(22,57)|(23,15),(23,16)|(24,57),(25,57)|(26,14),(26,15)|(28,6),(28,7)|(28,8),(28,10)|(28,11),(28,14)|(28,57),(28,66)|(29,5),(29,6)|(29,7),(29,8)|(29,10),(29,11)|(30,4),(30,5)|(32,66),(32,67)|(33,3),(33,4)|(33,50),(33,53)|(33,63),(33,67)|(36,3),(36,4)|(36,50),(36,53)|(36,63),(36,68)|(37,3),(37,4)|(38,65),(38,68)|(39,3),(39,4)|(40,24),(40,26)|(40,44),(40,47)|(41,4),(41,5)|(41,7),(41,8)|(41,65),(41,68)|(42,5),(42,7)|(42,8),(42,12)|(42,26),(42,43)|(42,56),(42,68)|(43,12),(43,13)|(44,12),(44,13)|(44,29),(44,43)|(44,47),(44,55)|(45,30),(45,43)|(46,25),(46,29)|(46,44),(46,55)|(47,25),(47,29)|(47,44),(47,56)|(48,23),(48,24)|(49,23),(49,24)|(50,3),(50,12)|(51,3),(51,6)|(54,3),(54,6)|(56,3),(56,9)|(58,44),(58,67)|(59,3),(59,9)|(60,43),(60,66)|(62,3),(62,6)|(62,24),(62,29)|(62,30),(62,66)|(62,67),(62,68)|(62,71),(62,75)|(62,76),(62,78)|(63,75),(63,76)|(64,68),(64,71)|(65,4),(65,6)|(69,4),(69,6)|(69,15),(69,18)|(72,4),(72,6)|(72,15),(72,18)|(78,4),(78,8)|(78,23),(78,26)|(81,4),(81,8)|(81,23),(81,26)|(82,68),(86,70)|(86,72),(87,4)|(87,6),(87,11)|(87,14),(87,31)|(87,34),(88,68)|(88,72),(90,4)|(90,6),(90,11)|(90,14),(90,31)|(90,34),(94,4)|(94,5),(96,68)|(96,71),(97,3)|(97,5),(97,53)|(97,56),(97,74)|(97,75),(98,3)|(98,7),(98,15)|(98,53),(98,56)|(98,66),(98,67)|(98,68),(98,71)|(98,74),(98,75)|(98,78),(100,7)|(100,12),(100,13)|(100,15),(100,66)|(100,67),(102,12)|
(8,3),(11,3)|(12,3),(14,3)|(33,3),(36,3)|(37,3),(39,3)|(50,3),(51,3)|(54,3),(56,3)|(59,3),(62,3)|(97,3),(98,3)|(7,4),(8,4)|(11,4),(12,4)|(14,4),(17,4)|(30,4),(33,4)|(36,4),(37,4)|(39,4),(41,4)|(65,4),(69,4)|(72,4),(78,4)|(81,4),(87,4)|(90,4),(94,4)|(6,5),(7,5)|(17,5),(18,5)|(29,5),(30,5)|(41,5),(42,5)|(94,5),(97,5)|(28,6),(29,6)|(51,6),(54,6)|(62,6),(65,6)|(69,6),(72,6)|(87,6),(90,6)|(17,7),(18,7)|(28,7),(29,7)|(41,7),(42,7)|(98,7),(100,7)|(17,8),(18,8)|(28,8),(29,8)|(41,8),(42,8)|(78,8),(81,8)|(56,9),(59,9)|(6,10),(7,10)|(28,10),(29,10)|(6,11),(7,11)|(17,11),(18,11)|(28,11),(29,11)|(87,11),(90,11)|(17,12),(18,12)|(42,12),(43,12)|(44,12),(50,12)|(100,12),(102,12)|(43,13),(44,13)|(100,13),(102,13)|(18,14),(20,14)|(26,14),(28,14)|(87,14),(90,14)|(20,15),(21,15)|(23,15),(26,15)|(69,15),(72,15)|(98,15),(100,15)|(6,16),(7,16)|(22,16),(23,16)|(5,17),(7,17)|(5,18),(7,18)|(69,18),(72,18)|(6,19),(7,19)|(2,23),(6,23)|(48,23),(49,23)|(78,23),(81,23)|(4,24),(8,24)|(40,24),(48,24)|(49,24),(62,24)|(46,25),(47,25)|(6,26),(8,26)|(40,26),(42,26)|(78,26),(81,26)|(44,29),(46,29)|(47,29),(62,29)|(45,30),(62,30)|(87,31),(90,31)|(87,34),(90,34)|(4,43),(6,43)|(42,43),(44,43)|(45,43),(60,43)|(2,44),(6,44)|(40,44),(46,44)|(47,44),(58,44)|(12,45),(15,45)|(1,47),(6,47)|(40,47),(44,47)|(12,48),(15,48)|(33,50),(36,50)|(33,53),(36,53)|(97,53),(98,53)|(44,55),(46,55)|(7,56),(10,56)|(42,56),(47,56)|(97,56),(98,56)|(18,57),(21,57)|(22,57),(24,57)|(25,57),(28,57)|(7,59),(10,59)|(12,62),(15,62)|(33,63),(36,63)|(2,64),(5,64)|(3,65),(4,65)|(38,65),(41,65)|(3,66),(4,66)|(7,66),(10,66)|(16,66),(18,66)|(28,66),(32,66)|(60,66),(62,66)|(98,66),(100,66)|(15,67),(16,67)|(32,67),(33,67)|(58,67),(62,67)|(98,67),(100,67)|(1,68),(2,68)|(5,68),(7,68)|(10,68),(12,68)|(36,68),(38,68)|(41,68),(42,68)|(62,68),(64,68)|(82,68),(88,68)|(96,68),(98,68)|(86,70),(62,71)|(64,71),(96,71)|(98,71),(86,72)|(88,72),(97,74)|(98,74),(62,75)|(63,75),(97,75)|(98,75),(62,76)|(63,76),(62,78)|