Pièce : UW_D02
taille : 48x154
######....................................######
######....................................######
######....................................######
######....................................######
######.........|..........................######
######.........|..........................######
######........###.........................######
####=..........|...........................=####
######.........|..........................######
######.........|..........................######
######...|.....|..........................######
######...|.....|..........................######
######...|.....|..........................######
######...|.....|.....|....................######
######...|.....|.....|....................######
######...|.....|.....|....................######
######..###....|....###........|..........######
######...|.....|.....|.........|..........######
##.......|.....|.....|.........|..........######
##.###...|.....|.....|.........|..........######
##.####..|.....|.....|.........|.........#######
##.########...###...###........|.........#######
##.#####################.......|........########
##...........#####.#####.......|........########
############.#####.#####.......|........########
############.#####.#####.......|........########
##.................#####.......|........########
##.#########.###########.......|........########
##.#########.###########.......|........########
##.###..###...###...###........|..........######
##.###...|.....|.....|.........|..........######
##.###...|.....|.....|.........|..........######
##.......|....###....|.........|..........######
######...|.....|.....|.........|..........######
######...|.....|.....|.........|..........######
######...|.....|....###........|..........######
######..###....|.....|.........|..........######
######...|.....|.....|.........|.....|....######
######...|.....|.....|.........|.....|....######
######...|.....|.....|........###....|....######
######-..|.....|.....|.........|.....|....######
######...|.....|.....|.........|.....|....######
######...|.....|.....|.........|.....|....######
######...|....###....|.........|....###...######
######...|.....|.....|.........|.....|....######
####=....|.....|.....|.........|.....|....######
######...|.....|.....|.........|.....|....######
######...|.....|.....|.........|.....|....######
######...|.....|...............|.....|...-######
######...|.....|..............###....|....######
######..###....|...............|.....|....######
######...|.....|...............|.....|....######
######...|.....|...............|.....|...-######
######.........|...............|.....|....######
######.........|.........|.....|.....|....######
######.........|........###....|....###...######
######.........|.........|.....|.....|....######
######.........|.........|.....|.....|.........#
######.........|.........|.....|.....|....####.#
######.........|........###...###...###.######.#
########.......|.......#######################.#
########.......|.......#####...................#
########...............###########.#############
########...............###########.#############
########...............###########.............#
########...............###########.###########.#
########...............###########.###########.#
######..................###...###...###...####.#
######...................|.....|.....|....####.#
######...................|...........|....####.#
######...................|...........|.........#
######...................|...........|....######
######...................|...........|....######
######-..................|.....|....###...######
######..................###....|.....|....######
######...................|.....|.....|....######
######...................|.....|.....|....######
######...................|.....|.....|....######
######...................|.....|.....|....######
######-........................|.....|....######
######.........................|..........######
######.........................|..........######
######.........................|..........######
######.........................|..........######
####=..........................|..........######
######...................|.....|..........######
######...................|.....|..........######
######...................|.....|.....|....######
######..................###....|.....|....######
######-..................|.....|.....|....######
######...................|.....|.....|....######
######...................|.....|....###...######
######...................|.....|.....|....######
######...................|....###....|....######
######...................|.....|.....|....######
######...................|.....|.....|....######
######..........|........|.....|.....|...#######
######..........|.......###...###...###.########
########........|......#########################
########........|......###########.#############
########........|......#####.......#############
########........|......#####.#####.#############
########........|......#####.#####............##
########........|......#####.################.##
########........|......#####.################.##
######..........|.......###...###...###...###.##
######..........|........|.....|.....|....###.##
######..........|........|.....|.....|....###.##
######..........|........|....###....|....###.##
######..........|........|.....|.....|........##
######-.........|........|.....|.....|....######
######..........|.......###....|.....|....######
######..........|........|.....|.....|....######
######....|.....|........|.....|.....|....######
######....|.....|........|.....|....###...######
######....|.....|........|.....|.....|....######
######....|....###.......|.....|.....|....######
######....|.....|........|.....|.....|....######
######....|.....|........|.....|.....|....######
######-...|.....|........|....###....|....######
######....|.....|..............|.....|....######
######....|.....|..............|.....|....######
######....|.....|..............|.....|....######
######....|.....|..............|.....|....######
######....|....###.............|..........######
######....|.....|..............|..........######
######....|.....|..............|.........-######
######....|.....|.....|........|..........######
######...###....|.....|........|..........######
######....|.....|.....|........|..........######
######....|.....|....###.......|..........######
######....|.....|.....|...................######
######....|.....|.....|..................-######
######....|....###....|...................######
####=.....|.....|.....|...................######
######...###....|.....|...................######
#######.#####..###...###.................#######
#########################...............########
#############.###########...............########
#############.......#####...............########
###################.#####...............########
###.................#####...............########
###.###############.#####...............########
###.###############.#####...............########
###.##...###...###...###..................######
###.##....|.....|.....|...................######
###.......|.....|.....|...................######
######...###....|.....|...................######
######....|.....|....###..................######
######....|.....|.....|....................=####
######..........|.....|...................######
######..........|.........................######
######....................................######
######....................................######
(2,18),(2,24)|(2,26),(2,33)|(3,19),(3,23)|(3,27),(3,32)|(3,141),(3,147)|(4,7),(4,8)|(4,45),(4,46)|(4,84),(4,85)|(4,134),(4,135)|(4,142),(4,146)|(6,0),(6,7)|(6,8),(6,18)|(6,19),(6,20)|(6,29),(6,32)|(6,33),(6,45)|(6,46),(6,60)|(6,67),(6,84)|(6,85),(6,98)|(6,105),(6,134)|(6,135),(6,136)|(6,144),(6,146)|(6,147),(6,154)|(7,20),(7,21)|(7,136),(7,137)|(8,16),(8,17)|(8,29),(8,30)|(8,36),(8,37)|(8,50),(8,51)|(8,60),(8,67)|(8,98),(8,105)|(8,136),(8,137)|(9,128),(9,129)|(9,135),(9,136)|(9,144),(9,145)|(9,147),(9,148)|(11,16),(11,17)|(11,21),(11,22)|(11,29),(11,30)|(11,36),(11,37)|(11,50),(11,51)|(12,24),(12,26)|(12,27),(12,29)|(12,128),(12,129)|(12,135),(12,136)|(12,144),(12,145)|(12,147),(12,148)|(13,23),(13,26)|(13,27),(13,29)|(13,136),(13,137)|(13,138),(13,140)|(14,6),(14,7)|(14,21),(14,22)|(14,29),(14,30)|(14,32),(14,33)|(14,43),(14,44)|(14,138),(14,139)|(15,116),(15,117)|(15,124),(15,125)|(15,133),(15,134)|(15,136),(15,137)|(15,144),(15,145)|(17,6),(17,7)|(17,21),(17,22)|(17,29),(17,30)|(17,32),(17,33)|(17,43),(17,44)|(18,23),(18,26)|(18,116),(18,117)|(18,124),(18,125)|(18,133),(18,134)|(18,136),(18,137)|(18,144),(18,145)|(19,23),(19,27)|(19,140),(19,141)|(19,142),(19,144)|(20,16),(20,17)|(20,21),(20,22)|(20,29),(20,30)|(20,35),(20,36)|(20,139),(20,144)|(21,130),(21,131)|(21,136),(21,137)|(21,144),(21,145)|(21,148),(21,149)|(23,16),(23,17)|(23,21),(23,22)|(23,29),(23,30)|(23,35),(23,36)|(23,60),(23,67)|(23,98),(23,105)|(24,22),(24,29)|(24,55),(24,56)|(24,59),(24,60)|(24,67),(24,68)|(24,74),(24,75)|(24,88),(24,89)|(24,97),(24,98)|(24,105),(24,106)|(24,111),(24,112)|(24,130),(24,131)|(24,136),(24,137)|(24,144),(24,145)|(24,148),(24,149)|(25,137),(25,144)|(27,55),(27,56)|(27,59),(27,60)|(27,67),(27,68)|(27,74),(27,75)|(27,88),(27,89)|(27,97),(27,98)|(27,105),(27,106)|(27,111),(27,112)|(28,61),(28,62)|(28,100),(28,105)|(29,101),(29,105)|(30,39),(30,40)|(30,49),(30,50)|(30,59),(30,60)|(30,67),(30,68)|(30,93),(30,94)|(30,97),(30,98)|(30,105),(30,106)|(30,108),(30,109)|(30,119),(30,120)|(33,39),(33,40)|(33,49),(33,50)|(33,59),(33,60)|(33,67),(33,68)|(33,93),(33,94)|(33,97),(33,98)|(33,105),(33,106)|(33,108),(33,109)|(33,119),(33,120)|(34,62),(34,67)|(34,99),(34,100)|(34,101),(34,103)|(35,62),(35,64)|(35,65),(35,67)|(35,99),(35,102)|(36,43),(36,44)|(36,55),(36,56)|(36,59),(36,60)|(36,67),(36,68)|(36,73),(36,74)|(36,91),(36,92)|(36,97),(36,98)|(36,105),(36,106)|(36,114),(36,115)|(39,43),(39,44)|(39,55),(39,56)|(39,59),(39,60)|(39,67),(39,68)|(39,73),(39,74)|(39,91),(39,92)|(39,97),(39,98)|(39,105),(39,106)|(39,114),(39,115)|(40,22),(40,29)|(40,59),(40,60)|(40,97),(40,98)|(40,137),(40,144)|(41,20),(41,22)|(41,96),(41,97)|(41,136),(41,137)|(42,0),(42,7)|(42,8),(42,20)|(42,29),(42,57)|(42,58),(42,59)|(42,67),(42,70)|(42,71),(42,96)|(42,105),(42,109)|(42,110),(42,136)|(42,144),(42,149)|(42,150),(42,154)|(44,7),(44,8)|(44,149),(44,150)|(45,103),(45,109)|(46,58),(46,61)|(46,65),(46,70)|(46,102),(46,110)|(47,57),(47,62)|(47,64),(47,71)|
(6,0),(42,0)|(14,6),(17,6)|(4,7),(6,7)|(14,7),(17,7)|(42,7),(44,7)|(4,8),(6,8)|(42,8),(44,8)|(8,16),(11,16)|(20,16),(23,16)|(8,17),(11,17)|(20,17),(23,17)|(2,18),(6,18)|(3,19),(6,19)|(6,20),(7,20)|(41,20),(42,20)|(7,21),(11,21)|(14,21),(17,21)|(20,21),(23,21)|(11,22),(14,22)|(17,22),(20,22)|(23,22),(24,22)|(40,22),(41,22)|(3,23),(13,23)|(18,23),(19,23)|(2,24),(12,24)|(2,26),(12,26)|(13,26),(18,26)|(3,27),(12,27)|(13,27),(19,27)|(6,29),(8,29)|(11,29),(12,29)|(13,29),(14,29)|(17,29),(20,29)|(23,29),(24,29)|(40,29),(42,29)|(8,30),(11,30)|(14,30),(17,30)|(20,30),(23,30)|(3,32),(6,32)|(14,32),(17,32)|(2,33),(6,33)|(14,33),(17,33)|(20,35),(23,35)|(8,36),(11,36)|(20,36),(23,36)|(8,37),(11,37)|(30,39),(33,39)|(30,40),(33,40)|(14,43),(17,43)|(36,43),(39,43)|(14,44),(17,44)|(36,44),(39,44)|(4,45),(6,45)|(4,46),(6,46)|(30,49),(33,49)|(8,50),(11,50)|(30,50),(33,50)|(8,51),(11,51)|(24,55),(27,55)|(36,55),(39,55)|(24,56),(27,56)|(36,56),(39,56)|(42,57),(47,57)|(42,58),(46,58)|(24,59),(27,59)|(30,59),(33,59)|(36,59),(39,59)|(40,59),(42,59)|(6,60),(8,60)|(23,60),(24,60)|(27,60),(30,60)|(33,60),(36,60)|(39,60),(40,60)|(28,61),(46,61)|(28,62),(34,62)|(35,62),(47,62)|(35,64),(47,64)|(35,65),(46,65)|(6,67),(8,67)|(23,67),(24,67)|(27,67),(30,67)|(33,67),(34,67)|(35,67),(36,67)|(39,67),(42,67)|(24,68),(27,68)|(30,68),(33,68)|(36,68),(39,68)|(42,70),(46,70)|(42,71),(47,71)|(36,73),(39,73)|(24,74),(27,74)|(36,74),(39,74)|(24,75),(27,75)|(4,84),(6,84)|(4,85),(6,85)|(24,88),(27,88)|(24,89),(27,89)|(36,91),(39,91)|(36,92),(39,92)|(30,93),(33,93)|(30,94),(33,94)|(41,96),(42,96)|(24,97),(27,97)|(30,97),(33,97)|(36,97),(39,97)|(40,97),(41,97)|(6,98),(8,98)|(23,98),(24,98)|(27,98),(30,98)|(33,98),(36,98)|(39,98),(40,98)|(34,99),(35,99)|(28,100),(34,100)|(29,101),(34,101)|(35,102),(46,102)|(34,103),(45,103)|(6,105),(8,105)|(23,105),(24,105)|(27,105),(28,105)|(29,105),(30,105)|(33,105),(36,105)|(39,105),(42,105)|(24,106),(27,106)|(30,106),(33,106)|(36,106),(39,106)|(30,108),(33,108)|(30,109),(33,109)|(42,109),(45,109)|(42,110),(46,110)|(24,111),(27,111)|(24,112),(27,112)|(36,114),(39,114)|(36,115),(39,115)|(15,116),(18,116)|(15,117),(18,117)|(30,119),(33,119)|(30,120),(33,120)|(15,124),(18,124)|(15,125),(18,125)|(9,128),(12,128)|(9,129),(12,129)|(21,130),(24,130)|(21,131),(24,131)|(15,133),(18,133)|(4,134),(6,134)|(15,134),(18,134)|(4,135),(6,135)|(9,135),(12,135)|(6,136),(7,136)|(8,136),(9,136)|(12,136),(13,136)|(15,136),(18,136)|(21,136),(24,136)|(41,136),(42,136)|(7,137),(8,137)|(13,137),(15,137)|(18,137),(21,137)|(24,137),(25,137)|(40,137),(41,137)|(13,138),(14,138)|(14,139),(20,139)|(13,140),(19,140)|(3,141),(19,141)|(4,142),(19,142)|(6,144),(9,144)|(12,144),(15,144)|(18,144),(19,144)|(20,144),(21,144)|(24,144),(25,144)|(40,144),(42,144)|(9,145),(12,145)|(15,145),(18,145)|(21,145),(24,145)|(4,146),(6,146)|(3,147),(6,147)|(9,147),(12,147)|(9,148),(12,148)|(21,148),(24,148)|(21,149),(24,149)|(42,149),(44,149)|(42,150),(44,150)|(6,154),(42,154)|


(9.5,10),(9.5,16)|(9.5,17),(9.5,21)|(9.5,30),(9.5,36)|(9.5,37),(9.5,50)|(9.5,51),(9.5,53)|(10.5,113),(10.5,128)|(10.5,129),(10.5,135)|(10.5,145),(10.5,147)|(10.5,148),(10.5,150)|(15.5,4),(15.5,6)|(15.5,7),(15.5,21)|(15.5,30),(15.5,32)|(15.5,33),(15.5,43)|(15.5,44),(15.5,62)|(16.5,96),(16.5,116)|(16.5,117),(16.5,124)|(16.5,125),(16.5,133)|(16.5,134),(16.5,136)|(16.5,145),(16.5,152)|(21.5,13),(21.5,16)|(21.5,17),(21.5,21)|(21.5,30),(21.5,35)|(21.5,36),(21.5,48)|(22.5,127),(22.5,130)|(22.5,131),(22.5,136)|(22.5,145),(22.5,148)|(22.5,149),(22.5,151)|(25.5,54),(25.5,55)|(25.5,56),(25.5,59)|(25.5,68),(25.5,74)|(25.5,75),(25.5,79)|(25.5,85),(25.5,88)|(25.5,89),(25.5,97)|(25.5,106),(25.5,111)|(25.5,112),(25.5,120)|(31.5,16),(31.5,39)|(31.5,40),(31.5,49)|(31.5,50),(31.5,59)|(31.5,68),(31.5,69)|(31.5,73),(31.5,93)|(31.5,94),(31.5,97)|(31.5,106),(31.5,108)|(31.5,109),(31.5,119)|(31.5,120),(31.5,131)|(37.5,37),(37.5,43)|(37.5,44),(37.5,55)|(37.5,56),(37.5,59)|(37.5,68),(37.5,73)|(37.5,74),(37.5,80)|(37.5,87),(37.5,91)|(37.5,92),(37.5,97)|(37.5,106),(37.5,114)|(37.5,115),(37.5,124)|
(6,40.5),(7,40.5)|(41,48.5),(42,48.5)|(41,52.5),(42,52.5)|(6,73.5),(7,73.5)|(6,79.5),(7,79.5)|(6,89.5),(7,89.5)|(6,110.5),(7,110.5)|(6,119.5),(7,119.5)|(41,126.5),(42,126.5)|(41,132.5),(42,132.5)|
end file : UW_D02