Pièce : UW_F01
taille : 59x228
...........................................................
...........................................................
...........................................................
...........................................................
........................................................../
........................................................./#
......................................................../##
......................................................./###
....................................................../####
......................................................#####
......................................................#####
......................................................#####
......................................................#####
......................................................#####
......................................................#####
.....................................................######
...................................................########
..................................................#########
..................................................#########
..................................................#########
..................................................#########
...................................................#..#####
...................................................#...=###
...................................................#..#####
...................................................#...=###
...................................................#..#####
................................................###H#######
................................................###########
................................................###########
................................................###########
...................................................#..#####
...................................................#..#####
...................................................#..#####
...................................................#..#####
...................................................#..#####
...................................................#..#####
...................................................#..#####
...................................................#..#####
...................................................#..#####
...................................................#..#####
...................................................#..#####
...................................................#..#####
...................................................#..#####
...................................................#..#####
...................................................#..#####
...................................................#..#####
...................................................#..#####
...................................................#..#####
...................................................#..#####
...................................................#..#####
...................................................#..#####
...................................................#..#####
......................................................#####
......................................................#####
......................................................#####
......................................................#####
.......................................................####
...................................................#...####
...................................................#...####
...................................................#...####
...................................................#...####
...................................................#...####
...................................................#...####
...................................................#...####
...................................................#...####
...................................................#...####
...................................................#...####
...................................................#...####
...................................................#...####
...................................................#...####
...............................................#...#..#####
...............................................#...#..#####
...............................................#...#..#####
...............................................#...#..#####
...............................................#...#..#####
...............................................#...#..#####
.............................................--+---+-######
...............................................#...#..#####
...............................................#...#..#####
...............................................#...#..#####
...............................................#...#..#####
...........................................----+---+-######
...............................................#...#..#####
...............................................#...#..#####
...............................................#...#..#####
...............................................#...#...####
...............................................#...#...####
...............................................#...#...####
...............................................#...#...####
...................................................#...####
...................................................#...####
...................................................#...####
...................................................#...####
...............................................#...#...####
...............................................#...#...####
...............................................#...#...####
...............................................#...#..#####
...............................................#...#..#####
...............................................#...#......#
...............................................#...##.###.#
...............................................##########.#
.............................................############.#
................................./#######################.#
.................................########################.#
.................................########################.#
.................................########################.#
.................................########################.#
.................................########################.#
.................................########################.#
................................./#######################.#
...............................................##########.#
...............................................##########.#
......................................................###.#
..................................................#######.#
............................................#############.#
..................................................#######.#
..................................................#######.#
...............................................##########.#
..................................................#######.#
..................................................#######.#
.............................................############.#
......................................................###.#
..........................................................#
.........................................###..........#####
....................................###H###################
....................................#######################
....................................#######################
.......................................#..............#####
.......................................#..............#####
.......................................#............#######
.......................................#....###############
.......................................#....###############
.......................................#....###############
.......................................#....###############
.......................................#....###############
.......................................#....###############
.......................................#....###############
.......................................#....###############
.......................................#....###############
.......................................#.....#...#....#####
.......................................#.....#...#....#####
.......................................#.....#...#........#
.......................................#.....#...#....###.#
...................................####H#########H#######.#
...................................######################.#
...................................######################.#
.......................................#.....#...#....###.#
.......................................#.....#...#....###.#
.......................................#.....#...#....###.#
......................................###...###..#....###.#
......................................###...###..#....###.#
......................................###...###..#....###.#
.......................................#.....#...#....###.#
.......................................#.....#...#....###.#
.......................................#.....#...#........#
.......................................#....###..##...#####
.......................................#..#################
.......................................#..#################
.......................................#..#################
...........................................=###############
..........................................#################
...........................................=###############
..........................................#################
.........................................##################
........................................###################
.....................................##H###################
.....................................######################
.....................................######################
.......................................#..#################
.......................................#..#################
.......................................#.....#...#....#####
.......................................#.....#...#....#####
.......................................#.....#...#....#####
.......................................#.....#...#........#
.......................................#.....#...#....###.#
.......................................#.....#...#....###.#
.......................................#..###H###H#######.#
.......................................#..###############.#
.......................................#..###############.#
.......................................#.....#...#....###.#
.......................................#.....#...#....###.#
.......................................#.....#...#....###.#
.......................................#.....#...#....###.#
......................................##.....#...#........#
.....................................####....#...#..#######
.............................###---########################
.............................###...##########=###=#########
...........................#####...########################
...........................#####---########################
...........................#####...########################
........./######################...########################
.........#######################---########################
.........#######################...########################
.........#######################...########################
.........#######################---########################
.........#######################...########################
.........#######################...########################
........./######################---########################
...........................#####...########################
......................--##--=###...########################
........................##.#####---########################
....../#########################...########################
......##########################...########################
......##########################---########################
......##########################...########################
......##########################...########################
......##########################---########################
......##########################...########################
....../#########################...########################
........................##.#####---########################
......................--##-#####...########################
.............................###...########################
.............................###---########################
.............................###...########################
.............................###......................#####
.............................###.......................=###
.............................####.....................#####
.............................####......................=###
.............................##########.............#######
.............................##############################
.............................##############=###############
.............................##############################
.............................##############################
.............................##############################
...............................###........###.........#####
..........................................###.........#####
......................................................#####
......................................................#####