Pièce : UW_I01
taille : 154x110
##########################################################################################################################################################
##########################################################################################################################################################
##########################################################################################################################################################
##########################################################################################################################################################
##########################################################################################################################################################
##########################################################################################################################################################
##########################################################################################################################################################
######..................................|.....................|.|.....................|.|.....................|.......................|.|.........########
####=...................................|.....................|.|.....................|.|.....................|.........................|..........=######
######................................|.|.....................|.|.....................|.|.....................|...................................########
####=.................................|.|.....................|.|.....................|.|.....................|....................................=######
######........###...###...###.........|.|.....................|.|.....................|.|.....................|.|.................................########
######.......##=###.#=##.##=###.......|.|.....................|.|.....................|.|.....................####................................########
##########################################################################################################################################################
##########################################################################################################################################################
##########################################################################################################################################################
##########################################################################################################################################################
##########################################################################################################################################################
##########################################################################################################################################################
###########/####################/#############/###########################################################################################################
##########/##########//##########/###########/##########/#################################################################################################
#########/########################/#########/###########################...###.....###...###...................#...........................###############
/#######/##########################/#######/######################.###.....###.....###...###...................|..................................########
################################################################...###.....###.....###....|....................|......................................####
###############################################################....###.....###.....###....|....................|..................................###.####
##########################################################..###....###.....###.....###....|........|...........|..#####################H##H##########.####
#########################################################...###.....|......###.....###....|........|...........|..#####################|##|##########.####
############/##################/###############/#########...###.....|......###.....###....|........|...........|..#####################|##|##########.####
###########/####################/#############/##########....|......|......###......|.....|........|...........|..|....................|..|.......###.####
#########################################################....|......|......###......|.....|........|...........|..|....................|..|...........####
#########################################################....|......|......###......|..............|...........|..|....................|..|.......########
#########################################################....|......|.......|.......|..............|...........|..|....................|..|...........####
###########/####################/#############/##########....|......|.......|.......|.............#H#.........####H#...............####H##H##.....###.####
############/##################/###############/#########....|......|.......|.......|........######.##############.#################.##=##=##########.####
#########################################################....|......|.......|.......|........######..................................################.####
#########################################################....#......|.......|.......|........######.##############.#################.################.####
#########################################################....|......|.......|.......|........######.##############.#################.################.####
#########################################################....|......|.......|.......|........######.##############.#################.################.####
/#######/##########################/#######/#############....|.....###......|.......|........######.##############.#################.################.####
#########/########################/#########/############....|.....###......|.......|........######.##############.#################.################.####
##########/##########//##########/###########/##########/....|.....###......|.......|...............##############.#################..................####
###########/####################/#############/##########....|......|.......|.......|.......######################.#################.################.####
#########################################################....|......|.......|.......|........#####################.#################.################.####
#########################################################....|......|.......|.......|........#####################.#################.################.####
#########################################################....|......|.......|......###.......#####################.......#####.......################.####
#########################################################....|......|.......|......###.......###########################.#####.######################.####
#########################################################....|......|.......|......###.......###########################.#####.######################.####
#########################################################....|......|.......|.......|........###########################.#####.######################.####
######........###.....................###....................|......|.......|.......|.........................|.|......#+#####+#......###.........###.####
####=.........###.....................###....................|......|.......|.......|.........................|.|.......|.....|.......###.........###.####
######........###.....................###....................|......|.......|.......|.........................|.|.......|.....|.......###.........###.####
####=.........###.....................###....................|......|.......|.......|.........................|.|.......|.....|.......###.............####
######.....#|#####|####........#|#....###...#|#.....................|.......|.......|.........................|.|.......|.....|.......###.........########
######.....#######=##=#........###....###...###.....................|.......|.......|.........................|.|......########.......###.......##########
#########################################################...........|.......|.......|........#############################################################
#########################################################...........|......###......|........#############################################################
#########################################################...........|.......|.......|........#############################################################
#########################################################...........|.......|.......|........#############################################################
#########################################################...........|.......|.......|........#############################################################
#########################################################..........###......|.......|........#############################################################
###########/####################/#############/##########..........###......|.......|........##########/#############/####################/#############/#
##########/##########//##########/###########/##########/..........###......|.......|......../##########/###########/##########//##########/###########/##
#########/########################/#########/############...........|.......|.......|........############/#########/########################/#########/###
/#######/##########################/#######/#############...........|.......|.......|........#############/#######/##########################/#######/####
#########################################################...........|.......|.......|........#############################################################
#########################################################...........|.......|.......|........#############################################################
#########################################################...........|.......|......###.......#############################################################
#########################################################...........|.......|.......|........#############################################################
############/##################/###############/#########...........|.......|.......|........#########/###############/##################/###############/
###########/####################/#############/##########...........|.......|.......|........##########/#############/####################/#############/#
#########################################################...........|.......|.......|........#############################################################
#########################################################...........|.......|.......|........#############################################################
#########################################################...........|.......|.......|........#############################################################
###########/####################/#############/##########...........|.......|.......|........##########/#############/####################/#############/#
############/##################/###############/#########...........|.......|.......|........#########/###############/##################/###############/
#########################################################...........|.......|.......|........#############################################################
#########################################################...........|.......|.......|........#############################################################
#########################################################...........|......###......|........#############################################################
#########################################################...........|......###......|........#############################################################
/#######/##########################/#######/#############...........|......###......|........#############/#######/##########################/#######/####
#########/########################/#########/############...........|.......|.......|........############/#########/########################/#########/###
##########/##########//##########/###########/##########/...........|.......|.......|......../##########/###########/##########//##########/###########/##
###########/####################/#############/###########..........|.......|.......|........##########/#############/####################/#############/#
############################################################........|.......|.......|........#############################################################
############################################################........|.......|.......|........#############################################################
############################################################........|.......|.......|........#############################################################
############################################################........|.......|.......|........#############################################################
############################################################.......###......|.......|........#############################################################
############################################################.......###......|.......|........#############################################################
######........|.|.....................|.|..........................###......|.......|.........................|.......................|.|.........########
####=.........|.......................|.|...........................|.......|.......|.........................|.......................|.|..........=######
######........|.......................|.|...........................|.......|.......|.................................................|.|.........########
####=.........|.......................|.|...................................|......###..........................|.....................|.|..........=######
######........|.|.....................|.|...................................|......###..........................|.....................|.|.........########
######........|.|.....................|.|...................................|......###..........................|.....................|.|.........########
############################################################................|.......|........#############################################################
############################################################................|.......|........#############################################################
############################################################................|.......|........#############################################################
############################################################................|.......|........#############################################################
############################################################................|.......|........#############################################################
############################################################................|................#############################################################
###########/####################/#############/###########..................|................##########/#############/####################/#############/#
##########/##########//##########/###########/##########/...................|................/##########/###########/##########//##########/###########/##
#########/########################/#########/############...................|................############/#########/########################/#########/###
/#######/##########################/#######/#############...................|................#############/#######/##########################/#######/####
#########################################################...................|................#############################################################
#########################################################...................|................#############################################################
#########################################################....................................#############################################################
#########################################################....................................#############################################################
############/##################/###############/#########....................................#########/###############/##################/###############/
(4,8),(4,9)|(4,10),(4,11)|(4,49),(4,50)|(4,51),(4,52)|(4,90),(4,91)|(4,92),(4,93)|(6,7),(6,8)|(6,9),(6,10)|(6,11),(6,13)|(6,48),(6,49)|(6,50),(6,51)|(6,52),(6,54)|(6,89),(6,90)|(6,91),(6,92)|(6,93),(6,95)|(11,52),(11,54)|(13,12),(13,13)|(14,11),(14,12)|(14,48),(14,52)|(15,12),(15,13)|(16,12),(16,13)|(17,11),(17,12)|(17,48),(17,52)|(18,54),(19,12)|(19,13),(19,54)|(20,11),(20,13)|(21,12),(21,13)|(21,53),(21,54)|(22,12),(22,13)|(22,53),(22,54)|(23,11),(23,12)|(23,52),(23,54)|(24,12),(24,13)|(25,12),(25,13)|(26,11),(26,12)|(27,12),(27,13)|(28,12),(28,13)|(29,11),(29,12)|(31,12),(31,13)|(31,52),(31,54)|(34,52),(34,54)|(38,48),(38,54)|(41,48),(41,54)|(44,52),(44,54)|(47,52),(47,54)|(57,26),(57,48)|(57,54),(57,110)|(58,25),(58,26)|(58,82),(58,83)|(58,101),(58,102)|(60,25),(60,28)|(60,83),(60,89)|(60,95),(60,101)|(63,24),(63,28)|(64,23),(64,24)|(66,22),(66,23)|(67,22),(67,26)|(67,38),(67,41)|(67,59),(67,62)|(67,87),(67,90)|(70,22),(70,26)|(70,38),(70,41)|(70,59),(70,62)|(70,87),(70,90)|(72,21),(72,22)|(75,21),(75,31)|(75,55),(75,56)|(75,77),(75,80)|(78,21),(78,31)|(78,55),(78,56)|(78,77),(78,80)|(83,21),(83,28)|(83,44),(83,47)|(83,66),(83,67)|(83,92),(83,95)|(86,21),(86,28)|(86,44),(86,47)|(86,66),(86,67)|(86,92),(86,95)|(89,21),(89,23)|(92,21),(92,23)|(92,41),(92,42)|(93,33),(93,40)|(93,42),(93,48)|(93,54),(93,89)|(93,95),(93,110)|(98,32),(98,33)|(99,40),(100,34)|(100,35),(100,41)|(101,32),(101,33)|(110,13),(110,32)|(110,33),(111,21)|(112,21),(114,12)|(114,13),(114,25)|(114,34),(114,35)|(114,45),(115,34)|(115,35),(115,44)|(116,32),(116,33)|(119,48),(119,49)|(119,53),(119,54)|(120,45),(121,44)|(126,44),(127,45)|(127,54),(128,48)|(128,49),(131,32)|(131,33),(132,33)|(132,34),(132,35)|(132,44),(133,33)|(133,40),(133,41)|(133,45),(134,48)|(134,54),(135,34)|(136,34),(137,48)|(137,54),(138,34)|(139,21),(139,22)|(139,34),(141,32)|(141,33),(144,53)|(144,54),(146,7)|(146,8),(146,9)|(146,10),(146,11)|(146,13),(146,22)|(146,23),(146,24)|(146,25),(146,28)|(146,29),(146,30)|(146,31),(146,32)|(146,33),(146,48)|(146,51),(146,52)|(146,53),(146,89)|(146,90),(146,91)|(146,92),(146,93)|(146,95),(148,8)|(148,9),(148,10)|(148,11),(148,90)|(148,91),(148,92)|(148,93),(149,24)|(149,29),(149,32)|(149,40),(149,41)|(149,51),(150,23)|(150,30),(150,31)|
(6,7),(146,7)|(4,8),(6,8)|(146,8),(148,8)|(4,9),(6,9)|(146,9),(148,9)|(4,10),(6,10)|(146,10),(148,10)|(4,11),(6,11)|(14,11),(17,11)|(20,11),(23,11)|(26,11),(29,11)|(146,11),(148,11)|(13,12),(14,12)|(15,12),(16,12)|(17,12),(19,12)|(21,12),(22,12)|(23,12),(24,12)|(25,12),(26,12)|(27,12),(28,12)|(29,12),(31,12)|(114,12),(6,13)|(13,13),(15,13)|(16,13),(19,13)|(20,13),(21,13)|(22,13),(24,13)|(25,13),(27,13)|(28,13),(31,13)|(110,13),(114,13)|(146,13),(72,21)|(75,21),(78,21)|(83,21),(86,21)|(89,21),(92,21)|(111,21),(112,21)|(139,21),(66,22)|(67,22),(70,22)|(72,22),(139,22)|(146,22),(64,23)|(66,23),(89,23)|(92,23),(146,23)|(150,23),(63,24)|(64,24),(146,24)|(149,24),(58,25)|(60,25),(114,25)|(146,25),(57,26)|(58,26),(67,26)|(70,26),(60,28)|(63,28),(83,28)|(86,28),(146,28)|(146,29),(149,29)|(146,30),(150,30)|(75,31),(78,31)|(146,31),(150,31)|(98,32),(101,32)|(110,32),(116,32)|(131,32),(141,32)|(146,32),(149,32)|(93,33),(98,33)|(101,33),(110,33)|(116,33),(131,33)|(132,33),(133,33)|(141,33),(146,33)|(100,34),(114,34)|(115,34),(132,34)|(135,34),(136,34)|(138,34),(139,34)|(100,35),(114,35)|(115,35),(132,35)|(67,38),(70,38)|(93,40),(99,40)|(133,40),(149,40)|(67,41),(70,41)|(92,41),(100,41)|(133,41),(149,41)|(92,42),(93,42)|(83,44),(86,44)|(115,44),(121,44)|(126,44),(132,44)|(114,45),(120,45)|(127,45),(133,45)|(83,47),(86,47)|(6,48),(14,48)|(17,48),(38,48)|(41,48),(57,48)|(93,48),(119,48)|(128,48),(134,48)|(137,48),(146,48)|(4,49),(6,49)|(119,49),(128,49)|(4,50),(6,50)|(4,51),(6,51)|(146,51),(149,51)|(4,52),(6,52)|(11,52),(14,52)|(17,52),(23,52)|(31,52),(34,52)|(44,52),(47,52)|(146,52),(150,52)|(21,53),(22,53)|(119,53),(144,53)|(146,53),(6,54)|(11,54),(18,54)|(19,54),(21,54)|(22,54),(23,54)|(31,54),(34,54)|(38,54),(41,54)|(44,54),(47,54)|(57,54),(93,54)|(119,54),(127,54)|(134,54),(137,54)|(144,54),(75,55)|(78,55),(75,56)|(78,56),(67,59)|(70,59),(67,62)|(70,62),(83,66)|(86,66),(83,67)|(86,67),(75,77)|(78,77),(75,80)|(78,80),(58,82)|(58,83),(60,83)|(67,87),(70,87)|(6,89),(60,89)|(93,89),(146,89)|(4,90),(6,90)|(67,90),(70,90)|(146,90),(148,90)|(4,91),(6,91)|(146,91),(148,91)|(4,92),(6,92)|(83,92),(86,92)|(146,92),(148,92)|(4,93),(6,93)|(146,93),(148,93)|(6,95),(60,95)|(83,95),(86,95)|(93,95),(146,95)|(58,101),(60,101)|(58,102),(57,110)|(12,109),(13,110)|(21,20),(22,21)|(21,40),(22,41)|(21,61),(22,62)|(21,81),(22,82)|(21,102),(22,103)|(31,109),(32,110)|(47,109),(48,110)|(56,40),(57,41)|(56,61),(57,62)|(56,81),(57,82)|(56,102),(57,103)|(102,109),(103,110)|(118,109),(119,110)|(127,61),(128,62)|(127,81),(128,82)|(127,102),(128,103)|(137,109),(138,110)|(153,68),(154,69)|(0,23),(1,22)|(0,39),(1,38)|(0,64),(1,63)|(0,80),(1,79)|(0,105),(1,104)|(8,23),(12,19)|(8,39),(9,38)|(8,64),(12,60)|(8,80),(9,79)|(8,80),(46,42)|(8,80),(47,41)|(8,105),(12,101)|(9,40),(10,39)|(9,81),(10,80)|(10,41),(11,40)|(10,82),(11,81)|(11,29),(13,27)|(11,33),(12,32)|(11,42),(12,41)|(11,70),(13,68)|(11,70),(47,34)|(11,70),(48,33)|(11,74),(12,73)|(11,83),(12,82)|(12,34),(13,33)|(12,75),(13,74)|(22,21),(23,20)|(22,41),(23,40)|(22,62),(23,61)|(22,62),(44,40)|(22,62),(45,39)|(22,82),(23,81)|(22,103),(23,102)|(22,103),(44,81)|(22,103),(45,80)|(31,28),(32,27)|(31,34),(33,32)|(31,69),(32,68)|(31,75),(33,73)|(32,20),(33,19)|(32,29),(33,28)|(32,42),(36,38)|(32,61),(33,60)|(32,70),(33,69)|(32,83),(36,79)|(32,102),(33,101)|(33,21),(34,20)|(33,62),(34,61)|(33,103),(34,102)|(34,22),(35,21)|(34,63),(35,62)|(34,104),(35,103)|(35,23),(36,22)|(35,64),(36,63)|(35,105),(36,104)|(43,23),(47,19)|(43,39),(44,38)|(43,64),(47,60)|(43,80),(44,79)|(43,105),(47,101)|(45,41),(46,40)|(45,82),(46,81)|(46,29),(48,27)|(46,33),(47,32)|(46,70),(48,68)|(46,74),(47,73)|(46,83),(47,82)|(47,75),(48,74)|(56,21),(57,20)|(93,62),(94,61)|(93,82),(94,81)|(93,103),(94,102)|(93,103),(115,81)|(93,103),(116,80)|(102,69),(103,68)|(102,75),(104,73)|(103,61),(104,60)|(103,70),(104,69)|(103,83),(107,79)|(103,102),(104,101)|(103,102),(141,64)|(103,102),(142,63)|(104,62),(105,61)|(104,103),(105,102)|(105,63),(106,62)|(105,104),(106,103)|(106,64),(107,63)|(106,105),(107,104)|(114,64),(118,60)|(114,80),(115,79)|(114,105),(118,101)|(116,82),(117,81)|(117,70),(119,68)|(117,74),(118,73)|(117,83),(118,82)|(118,75),(119,74)|(128,62),(129,61)|(128,82),(129,81)|(128,103),(129,102)|(128,103),(150,81)|(128,103),(151,80)|(137,69),(138,68)|(137,75),(139,73)|(138,61),(139,60)|(138,70),(139,69)|(138,83),(142,79)|(138,102),(139,101)|(139,62),(140,61)|(139,103),(140,102)|(140,63),(141,62)|(140,104),(141,103)|(141,105),(142,104)|(149,64),(153,60)|(149,80),(150,79)|(149,105),(153,101)|(151,82),(152,81)|(152,74),(153,73)|(152,83),(153,82)|(153,110),(154,109)|