Pièce : SU_A37
taille : 54x35
######################################################
######################################################
######################################################
############################......####=##=############
#######################|##|#......####.##.############
######=.....#...#......|..|....................=######
########...............|..|...................########
######=................|.......................=######
########......................................########
######=........................................=######
########..................|...................########
######=........###........|....................=######
########.......###.....|..|...................########
######=........###.....|..|....................=######
####################/..|..|......./###################
######################################################
#######################=##=###########################
######################################################
######################################################
######################################################
######################################################
######################################################
######################################################
######################################################
######################################################
######################################################
######################################################
######################################################
######################################################
######################################################
######################################################
######################################################
######################################################
######################################################
######################################################
(6,5),(6,6)|(6,7),(6,8)|(6,9),(6,10)|(6,11),(6,12)|(6,13),(6,14)|(8,6),(8,7)|(8,8),(8,9)|(8,10),(8,11)|(8,12),(8,13)|(12,5),(12,6)|(13,5),(13,6)|(15,11),(15,14)|(16,5),(16,6)|(17,5),(17,6)|(18,11),(18,14)|(23,4),(23,5)|(23,16),(23,17)|(24,4),(24,5)|(24,16),(24,17)|(26,4),(26,5)|(26,16),(26,17)|(27,4),(27,5)|(27,16),(27,17)|(28,3),(28,5)|(34,3),(34,5)|(38,3),(38,5)|(39,3),(39,5)|(41,3),(41,5)|(42,3),(42,5)|(46,6),(46,7)|(46,8),(46,9)|(46,10),(46,11)|(46,12),(46,13)|(48,5),(48,6)|(48,7),(48,8)|(48,9),(48,10)|(48,11),(48,12)|(48,13),(48,14)|
(28,3),(34,3)|(38,3),(39,3)|(41,3),(42,3)|(23,4),(24,4)|(26,4),(27,4)|(6,5),(12,5)|(13,5),(16,5)|(17,5),(23,5)|(24,5),(26,5)|(27,5),(28,5)|(34,5),(38,5)|(39,5),(41,5)|(42,5),(48,5)|(6,6),(8,6)|(12,6),(13,6)|(16,6),(17,6)|(46,6),(48,6)|(6,7),(8,7)|(46,7),(48,7)|(6,8),(8,8)|(46,8),(48,8)|(6,9),(8,9)|(46,9),(48,9)|(6,10),(8,10)|(46,10),(48,10)|(6,11),(8,11)|(15,11),(18,11)|(46,11),(48,11)|(6,12),(8,12)|(46,12),(48,12)|(6,13),(8,13)|(46,13),(48,13)|(6,14),(15,14)|(18,14),(48,14)|(23,16),(24,16)|(26,16),(27,16)|(23,17),(24,17)|(26,17),(27,17)|
(20,14),(21,15)|
(34,15),(35,14)|
(23.5,4),(23.5,8)|(23.5,12),(23.5,15)|(26.5,4),(26.5,7)|(26.5,10),(26.5,15)|

