Piece : SU_A30
48x35
-733x-331
################################################
################################################
################################################
################################################
################################################
################################################
################################################
################################################
################################################
##############=####=###=########################
##############.####|###.########################
############/......|...../######################
#########..........|......................######
########...........|.......................=####
#######............|......................######
#######.......|....|.......................=####
######........|....|......................######
######........|....|.......................=####
######........|....|......................######
#######.......|....|............#####......=####
#########.....|....|.........##########...######
############/.|....|...../######################
##############H####H############################
##############=####=###=########################
################################################
################################################
################################################
################################################
################################################
################################################
################################################
################################################
################################################
################################################
################################################
(6,16),(6,19)|(7,14),(7,16)|(7,19),(7,20)|(8,13),(8,14)|(9,12),(9,13)|(9,20),(9,21)|(14,9),(14,11)|(14,22),(14,24)|(15,9),(15,11)|(15,22),(15,24)|(19,9),(19,11)|(19,22),(19,24)|(20,9),(20,11)|(20,22),(20,24)|(23,9),(23,11)|(23,23),(23,24)|(24,9),(24,11)|(24,23),(24,24)|(29,20),(29,21)|(32,19),(32,20)|(37,19),(37,20)|(39,20),(39,21)|(42,12),(42,13)|(42,14),(42,15)|(42,16),(42,17)|(42,18),(42,19)|(42,20),(42,21)|(44,13),(44,14)|(44,15),(44,16)|(44,17),(44,18)|(44,19),(44,20)|
(14,9),(15,9)|(19,9),(20,9)|(23,9),(24,9)|(13,11),(14,11)|(15,11),(19,11)|(20,11),(23,11)|(24,11),(25,11)|(9,12),(12,12)|(26,12),(42,12)|(8,13),(9,13)|(42,13),(44,13)|(7,14),(8,14)|(42,14),(44,14)|(42,15),(44,15)|(6,16),(7,16)|(42,16),(44,16)|(42,17),(44,17)|(42,18),(44,18)|(6,19),(7,19)|(32,19),(37,19)|(42,19),(44,19)|(7,20),(9,20)|(29,20),(32,20)|(37,20),(39,20)|(42,20),(44,20)|(9,21),(12,21)|(26,21),(29,21)|(39,21),(42,21)|(13,22),(14,22)|(15,22),(19,22)|(20,22),(25,22)|(23,23),(24,23)|(14,24),(15,24)|(19,24),(20,24)|(23,24),(24,24)|
(12,21),(13,22)|(25,11),(26,12)|
(12,12),(13,11)|(25,22),(26,21)|
(14.5,15),(14.5,22)|(19.5,10),(19.5,22)|
None|
end file : SU_A30