Piece : SU_A24
54x35
748x-215
####################......|......#####################
####################/.....|......#####################
######################################################
#####################....###....######################
######################################################
#####################.....|.....######################
#####################.....|.....######################
#####################.....|.....######################
#####################.....|...../#####################
####################/.....|....../####################
####################......|.......##=###=#############
###########/.../###/......|......./#|#|#|#/..#########
#######/..................|.........|.|.|....#########
#######...................|.........|.|.|.../#########
######....................|...........|.....##########
#####/....................|................./#########
#####.........|...........|..................#########
####/.........|...........|..................#########
####..........|...........|..................#########
####..........|...........|.........#####....#########
####/.........|...........|.........#####.../#########
######./##/...|...........|.........#####/..##########
############/.|./##/......|.....#/..##################
##############H#####/.....|.....######################
##############=#######################################
#####################....###....######################
######################################################
####################/...........######################
####################............/#####################
####################.............#####################
####################.............#####################
####################/............#####################
#####################............#####################
#####################.........../#####################
#####################...........######################
(4,18),(4,20)|(5,16),(5,17)|(6,14),(6,15)|(6,21),(6,22)|(7,13),(7,14)|(14,23),(14,25)|(15,23),(15,25)|(20,0),(20,1)|(20,10),(20,11)|(20,28),(20,31)|(21,3),(21,4)|(21,5),(21,9)|(21,25),(21,26)|(21,32),(21,35)|(25,3),(25,4)|(25,25),(25,26)|(28,3),(28,4)|(28,25),(28,26)|(32,3),(32,4)|(32,5),(32,8)|(32,22),(32,24)|(32,25),(32,26)|(32,27),(32,28)|(32,34),(32,35)|(33,0),(33,2)|(33,29),(33,33)|(34,10),(34,11)|(36,10),(36,12)|(36,19),(36,23)|(37,10),(37,12)|(38,11),(38,12)|(39,11),(39,12)|(40,10),(40,12)|(41,10),(41,12)|(41,19),(41,21)|(44,14),(44,15)|(44,21),(44,22)|(45,11),(45,13)|(45,16),(45,20)|
(20,0),(33,0)|(21,2),(33,2)|(21,3),(25,3)|(28,3),(32,3)|(21,4),(25,4)|(28,4),(32,4)|(21,5),(32,5)|(36,10),(37,10)|(40,10),(41,10)|(12,11),(15,11)|(38,11),(39,11)|(43,11),(45,11)|(8,12),(11,12)|(16,12),(19,12)|(35,12),(36,12)|(37,12),(38,12)|(39,12),(40,12)|(41,12),(42,12)|(6,14),(7,14)|(36,19),(41,19)|(5,21),(6,21)|(8,21),(10,21)|(6,22),(7,22)|(11,22),(12,22)|(17,22),(19,22)|(32,22),(33,22)|(42,22),(44,22)|(13,23),(14,23)|(15,23),(16,23)|(34,23),(36,23)|(21,24),(32,24)|(14,25),(15,25)|(21,25),(25,25)|(28,25),(32,25)|(21,26),(25,26)|(28,26),(32,26)|(21,27),(32,27)|(21,35),(32,35)|
(4,20),(5,21)|(10,21),(11,22)|(10,21),(20,31)|(10,21),(21,32)|(12,22),(13,23)|(15,11),(16,12)|(15,11),(32,28)|(15,11),(33,29)|(19,22),(21,24)|(20,1),(21,2)|(32,8),(34,10)|(33,22),(34,23)|(34,11),(35,12)|(41,21),(42,22)|(44,15),(45,16)|
(4,18),(5,17)|(5,16),(6,15)|(7,13),(8,12)|(7,22),(8,21)|(11,12),(12,11)|(16,23),(17,22)|(19,12),(20,11)|(20,10),(21,9)|(20,28),(21,27)|(32,34),(33,33)|(42,12),(43,11)|(44,14),(45,13)|(44,21),(45,20)|
(14.5,16),(14.5,23)|(26.5,0),(26.5,2)|(26.5,5),(26.5,24)|(36.5,11),(36.5,14)|(38.5,11),(38.5,15)|(40.5,11),(40.5,14)|
None|
end file : SU_A24