Pièce : SU_B06
taille : 50x78
........................................##########
........................................##########
......................................../#########
.........................................#########
..........................................=#######
.........................................#########
..........................................=#######
.........................................#########
..........................................=#######
.........................................#########
....................................|.....=#######
....................................|....#########
....................................|.../#########
....................................|..###########
....................................|.############
................................/###H#############
.............................../####=#############
...............................###################
......................|...|....###################
......................|...|....###################
......................||.||....###################
.......|...|..........+###+..../##################
.......|...|.........-+###+-....##################
.......||.||..........+###+......=################
.......+###+..........||.||.....##################
......-+###+-.........|...|......=################
.......+###+..........|...|.....##################
.......||.||..........|...|......=################
.......|...|..........|...|.....##################
.......|...|..........|...|..../##################
.......|...|.........###..|..#####################
...../############################################
..../######=###=#########=########################
....##############################################
....##############################################
.----=############################################
....##############################################
....##############################################
...-##############################################
....##############################################
....##############################################
....##############################################
....##############################################
....##############################################
....##############################################
....##############################################
....##############################################
....##############################################
....##############################################
....##############################################
....##############################################
....##############################################
....##############################################
....##############################################
.....#############################################
.....#############################################
.....#############################################
.-----=###########################################
.....#############################################
....--=###########################################
.....#############################################
.....#############################################
.....#############################################
......############################################
.......###########################################
.......###########################################
.......###########################################
........##########################################
........##########################################
.......###########################################
.......###########################################
....-----#########################################
.......###########################################
......--=#########################################
.......###########################################
......############################################
......############################################
....##############################################
(4,35),(4,36)|(4,54),(4,77)|(5,54),(5,57)|(5,58),(5,59)|(5,60),(5,63)|(6,31),(6,35)|(6,36),(6,63)|(6,64),(6,75)|(7,57),(7,58)|(7,59),(7,60)|(7,64),(7,67)|(7,69),(7,71)|(7,72),(7,73)|(7,74),(7,75)|(8,24),(8,27)|(8,67),(8,69)|(9,71),(9,72)|(9,73),(9,74)|(11,24),(11,27)|(11,32),(11,33)|(12,32),(12,33)|(15,32),(15,33)|(16,32),(16,33)|(21,30),(21,31)|(23,21),(23,24)|(24,30),(24,31)|(25,32),(25,33)|(26,21),(26,24)|(26,32),(26,33)|(29,30),(29,31)|(32,23),(32,24)|(32,25),(32,26)|(32,27),(32,28)|(34,23),(34,24)|(34,25),(34,26)|(34,27),(34,28)|(36,15),(36,17)|(37,15),(37,17)|(38,14),(38,15)|(39,13),(39,14)|(41,4),(41,5)|(41,6),(41,7)|(41,8),(41,9)|(41,10),(41,11)|(43,4),(43,5)|(43,6),(43,7)|(43,8),(43,9)|(43,10),(43,11)|
(41,4),(43,4)|(41,5),(43,5)|(41,6),(43,6)|(41,7),(43,7)|(41,8),(43,8)|(41,9),(43,9)|(41,10),(43,10)|(41,11),(43,11)|(38,14),(39,14)|(33,15),(36,15)|(37,15),(38,15)|(36,17),(37,17)|(23,21),(26,21)|(32,23),(34,23)|(8,24),(11,24)|(23,24),(26,24)|(32,24),(34,24)|(32,25),(34,25)|(32,26),(34,26)|(8,27),(11,27)|(32,27),(34,27)|(32,28),(34,28)|(21,30),(24,30)|(6,31),(21,31)|(24,31),(29,31)|(11,32),(12,32)|(15,32),(16,32)|(25,32),(26,32)|(11,33),(12,33)|(15,33),(16,33)|(25,33),(26,33)|(4,35),(6,35)|(4,36),(6,36)|(4,54),(5,54)|(5,57),(7,57)|(5,58),(7,58)|(5,59),(7,59)|(5,60),(7,60)|(5,63),(6,63)|(6,64),(7,64)|(7,67),(8,67)|(7,69),(8,69)|(7,71),(9,71)|(7,72),(9,72)|(7,73),(9,73)|(7,74),(9,74)|(6,75),(7,75)|(4,77),(6,77)|
(31,21),(32,22)|(40,2),(41,3)|
(4,33),(6,31)|(31,17),(33,15)|(31,30),(32,29)|(40,13),(41,12)|
(7.5,21),(7.5,31)|(8.5,23),(8.5,24)|(8.5,27),(8.5,28)|(10.5,23),(10.5,24)|(10.5,27),(10.5,28)|(11.5,21),(11.5,31)|(22.5,18),(22.5,30)|(23.5,20),(23.5,21)|(23.5,24),(23.5,25)|(25.5,20),(25.5,21)|(25.5,24),(25.5,25)|(26.5,18),(26.5,31)|(36.5,10),(36.5,15)|
(1,35.5),(1,57.5)|(3,38.5),(4,38.5)|(4,59.5),(4,71.5)|(5,35.5),(6,25.5)|(6,57.5),(6,59.5)|(6,73.5),(8,73.5)|(9,71.5),(13,25.5)|(21,22.5),(28,22.5)|
end file : SU_B06