Pièce : SU_C04
taille : 155x35
##################################################################/.............###########################################################################
############/../##################################################.............../#########################################################################
############....../##############################################/................#########################################################################
###########/.......############################################/................../########################################################################
#########...........##########################################.....................########################################################################
############.......###############################################..............###########################################################################
#####=..................##############################...#####.......................#####......###########################################################
###############.....################################################..........#############################################################################
############...........############################................................../#####################################################################
##########/............/##########################....................................../##################################################################
##########..............#########################/......................................../################################################################
###########/............############/..../######/..........................................################################################################
############/...........##########........./###.............................................###############################################################
#############.........../#######/.........................................................../##############################################################
#############.............#####............................................................../##/....#########################################/.../########
############/........................................................................................../###################################......../#######
############............................................................................................./################################/.........#######
##########/.............................................................................................../#####/................/########..........#######
##########........................................................................................................................../####/..........#######
##########...........................................................................................................................................######
#########/.......................................................####............####................................................................######
#########........................................................####............####.................................................................#####
#########........................................................####............####.................................................................#####
#########........................................................####............####..................................................................=###
#########........................................................####............####.................................................................#####
##########.......................................................####............####.............................................................../######
##########.................................../#######/...........####............####.......###.../####/.............................###.........##########
##########/............................../###############........####............####.......###./#########....###...................#######################
############............#########/.....####################/................................###############################################################
##############........#####################################################################################################################################
################/.../#################################..........######..........######..........###########......##########################################
###########################################################################################################################################################
###########################################################################################################################################################
###########################################################################################################################################################
###########################################################################################################################################################
(5,6),(5,7)|(9,4),(9,5)|(10,11),(10,25)|(11,4),(11,11)|(12,5),(12,6)|(12,8),(12,9)|(12,17),(12,28)|(14,29),(14,30)|(15,7),(15,8)|(16,2),(16,30)|(19,4),(19,5)|(20,4),(20,5)|(20,7),(20,8)|(22,29),(22,30)|(24,6),(24,7)|(24,28),(24,29)|(26,14),(26,15)|(31,14),(31,15)|(34,12),(34,13)|(39,28),(39,29)|(42,12),(42,27)|(47,12),(47,13)|(51,8),(51,9)|(54,6),(54,7)|(54,30),(54,31)|(57,6),(57,7)|(57,27),(57,28)|(62,4),(62,5)|(62,6),(62,7)|(64,30),(64,31)|(65,3),(65,20)|(66,0),(66,5)|(68,7),(68,8)|(69,20),(69,28)|(70,30),(70,31)|(78,7),(78,8)|(80,0),(80,1)|(80,5),(80,6)|(80,30),(80,31)|(81,20),(81,28)|(85,6),(85,7)|(85,20),(85,28)|(86,9),(86,30)|(90,6),(90,7)|(92,12),(92,26)|(95,26),(95,28)|(96,6),(96,7)|(96,15),(96,30)|(101,14),(101,15)|(106,27),(106,28)|(107,18),(107,30)|(110,27),(110,28)|(113,27),(113,28)|(113,30),(113,31)|(132,27),(132,28)|(133,19),(133,26)|(136,26),(136,27)|(145,26),(145,27)|(149,19),(149,21)|(150,21),(150,23)|(150,24),(150,25)|(152,23),(152,24)|
(66,0),(80,0)|(9,4),(11,4)|(19,4),(20,4)|(62,4),(63,4)|(9,5),(12,5)|(19,5),(20,5)|(62,5),(66,5)|(80,5),(83,5)|(5,6),(12,6)|(19,6),(24,6)|(54,6),(57,6)|(62,6),(66,6)|(80,6),(85,6)|(90,6),(96,6)|(5,7),(15,7)|(20,7),(24,7)|(54,7),(57,7)|(62,7),(68,7)|(78,7),(85,7)|(90,7),(96,7)|(12,8),(15,8)|(20,8),(23,8)|(51,8),(68,8)|(12,9),(50,9)|(51,9),(86,9)|(10,11),(11,11)|(34,12),(36,12)|(42,12),(47,12)|(48,12),(91,12)|(34,13),(44,13)|(25,14),(26,14)|(31,14),(32,14)|(26,15),(31,15)|(94,15),(96,15)|(101,15),(139,15)|(107,18),(112,18)|(133,19),(137,19)|(148,19),(149,19)|(65,20),(69,20)|(81,20),(85,20)|(149,21),(150,21)|(150,23),(152,23)|(150,24),(152,24)|(9,25),(10,25)|(149,25),(150,25)|(46,26),(53,26)|(92,26),(95,26)|(99,26),(103,26)|(133,26),(136,26)|(42,27),(57,27)|(97,27),(106,27)|(110,27),(113,27)|(132,27),(133,27)|(136,27),(145,27)|(12,28),(24,28)|(33,28),(39,28)|(57,28),(59,28)|(65,28),(69,28)|(81,28),(85,28)|(95,28),(106,28)|(110,28),(113,28)|(12,29),(14,29)|(22,29),(24,29)|(39,29),(92,29)|(14,30),(16,30)|(21,30),(22,30)|(54,30),(64,30)|(70,30),(80,30)|(86,30),(96,30)|(107,30),(113,30)|(54,31),(64,31)|(70,31),(80,31)|(86,31),(96,31)|(107,31),(113,31)|
(10,27),(11,28)|(11,11),(13,13)|(15,1),(16,2)|(15,1),(23,9)|(15,1),(24,10)|(16,30),(17,31)|(18,2),(19,3)|(24,13),(25,14)|(33,28),(34,29)|(41,11),(42,12)|(43,12),(44,13)|(43,12),(59,28)|(43,12),(60,29)|(53,26),(54,27)|(81,1),(82,2)|(81,1),(90,10)|(81,1),(91,11)|(82,3),(83,4)|(82,3),(88,9)|(82,3),(89,10)|(82,3),(92,13)|(82,3),(94,15)|(85,8),(86,9)|(85,8),(103,26)|(85,8),(104,27)|(103,15),(104,16)|(105,16),(107,18)|(129,17),(130,18)|(132,18),(133,19)|(146,14),(148,16)|
(9,21),(10,20)|(10,10),(11,9)|(10,18),(11,17)|(10,18),(12,16)|(10,18),(13,15)|(11,4),(12,3)|(12,2),(13,1)|(20,31),(21,30)|(32,14),(33,13)|(36,12),(37,11)|(41,28),(42,27)|(45,27),(46,26)|(48,12),(50,10)|(63,4),(64,3)|(65,3),(66,2)|(96,15),(97,14)|(96,28),(97,27)|(98,27),(99,26)|(112,18),(113,17)|(137,19),(138,18)|(138,17),(139,16)|(142,15),(143,14)|(148,26),(149,25)|


end file : SU_C04