Pièce : LF_A12
taille : 48x35
################################################
################################################
################################################
################################################
################=#########=#####################
#####=##########.#########.#####################
#####.##########.#########.#####################
#####.##########.#########.#####################
#####.##########.#########.#####################
#####.##########.#########.#####################
#####.................................##########
################.#########.##########.##########
################+#########+##########.##########
###############.|.#######.|.#########.##########
###############...#######...#########.##########
###############...#######...#########.##########
###############...#######...#########.##########
###############...#######...#########.##########
###############...#######...#########.##########
#####################################.##########
################.#########.##########.##########
###############...#######...#########.##########
###############...#######...#########.##########
###############...#######...#########.##########
###############...#######...#########.##########
#####################################.##########
#####################################.##########
#####################################.##########
#####################################.##########
#####################################.....=#####
################################################
################################################
################################################
################################################
################################################
16,10|17,10|26,10|27,10|38,10|5,11|16,11|17,11|26,11|27,11|37,11|15,13|18,13|25,13|28,13|15,19|16,20|17,20|18,19|25,19|26,20|27,20|28,19|15,21|16,21|17,21|18,21|25,21|26,21|27,21|28,21|15,25|18,25|25,25|28,25|38,29|37,30|