Pièce : LF_A05
taille : 48x35
################################################
################################################
#################.##############################
#################.##############################
################..##############################
################...########################=####
###=############...########################.####
###.###########.....#######################.####
###.###########.....#######################.####
###.###########.....#######################.####
###.####################....................####
###.#############.######.####.####.####.########
###........######.######.####.####.####.########
##########.######.######.####+####+####+########
##########.######.######.###.|.##.|.##.|.#######
##########.######.######.###.|.##.|.##.|.#######
##########...............###.|.##.|.##.|.#######
#############.#######.#######+####+####+########
#############.#######.#######.####.####.########
#############+#######+#######.####.####.########
############.|.#####.|.######.####.####.########
############.|.#####.|.######......####....=####
###########/.../###/.|./###############.########
###########.....###..|..###############.########
###########.....###..|..###############.########
###########.....###..|..###############.########
###########/.|./###/.|./#####...........########
############.|.#####.|.######.##################
############.|.#####.|.######.##################
#############+#######+#######.##################
#############.#######.#######.##################
#########=.......................=##############
################################################
################################################
################################################
18,2|16,4|17,4|18,5|19,5|15,7|16,7|19,7|20,7|24,10|43,10|15,10|17,11|18,11|20,10|4,12|11,12|25,11|29,11|30,11|34,11|35,11|39,11|40,11|44,11|3,13|10,13|28,14|31,14|33,14|36,14|38,14|41,14|11,16|17,16|18,16|24,16|10,17|13,17|14,17|21,17|22,17|25,17|28,17|31,17|33,17|36,17|38,17|41,17|12,20|15,20|20,20|23,20|30,21|34,21|40,21|12,22|11,23|16,23|15,22|20,22|19,23|24,23|23,22|29,22|35,22|40,22|29,26|39,26|12,27|11,26|16,26|15,27|20,27|19,26|24,26|23,27|30,27|40,27|12,29|15,29|20,29|23,29|13,31|14,31|21,31|22,31|29,31|30,31|