Pièce : LF_A07
taille : 48x35
################################################
################################################
################################################
################################################
#######################=########################
#######################|########################
#####################..|..######################
#####################..|..######################
#####################..|..######################
#####################..|..######################
#####################..|..######################
#####################..|..######################
#####################..|..######################
#####################..|..######################
##################.....|.....###################
##################.....|.....###################
##################.....|.....###################
##################.....|.....###################
##################...........###################
#########................................#######
########................................########
#########...........#..................#########
##################.###.......###################
######################...#######################
######################...#######################
######################...#######################
######################...#######################
########/................#######################
########.................#######################
########................/#######################
########...#####################################
################################################
#########=######################################
################################################
################################################
(8,20),(8,21)|(8,31),(9,19)|(9,20),(9,21)|(9,22),(9,32)|(9,33),(10,32)|(10,33),(11,30)|(11,31),(18,14)|(18,19),(18,22)|(18,23),(19,22)|(19,23),(20,21)|(20,22),(21,6)|(21,14),(21,21)|(21,22),(22,22)|(22,27),(23,4)|(24,4),(25,23)|(26,6),(26,14)|(29,14),(29,19)|(29,22),(29,23)|(39,21),(39,22)|(40,20),(40,21)|(41,19),(41,20)|
(23,4),(24,4)|(21,6),(26,6)|(18,14),(21,14)|(26,14),(29,14)|(9,19),(18,19)|(29,19),(41,19)|(8,20),(9,20)|(40,20),(41,20)|(8,21),(9,21)|(20,21),(21,21)|(39,21),(40,21)|(9,22),(18,22)|(19,22),(20,22)|(21,22),(22,22)|(29,22),(39,22)|(18,23),(19,23)|(25,23),(29,23)|(22,27),(11,30)|(8,31),(11,31)|(9,32),(10,32)|(9,33),(10,33)|

(8,28),(9,27)|(24,30),(25,29)|
