Pièce : LF_A05
taille : 48x35
################################################
################################################
#################.##############################
#################.##############################
################..##############################
################...########################=####
###=############...########################.####
###.###########.....#######################.####
###.###########.....#######################.####
###.###########.....#######################.####
###.####################....................####
###.#############.######.####.####.####.########
###........######.######.####.####.####.########
##########.######.######.####+####+####+########
##########.######.######.###.|.##.|.##.|.#######
##########.######.######.###.|.##.|.##.|.#######
##########...............###.|.##.|.##.|.#######
#############.#######.#######+####+####+########
#############.#######.#######.####.####.########
#############+#######+#######.####.####.########
############.|.#####.|.######.####.####.########
############.|.#####.|.######......####....=####
###########/.../###/.|./###############.########
###########.....###..|..###############.########
###########.....###..|..###############.########
###########.....###..|..###############.########
###########/.|./###/.|./#####...........########
############.|.#####.|.######.##################
############.|.#####.|.######.##################
#############+#######+#######.##################
#############.#######.#######.##################
#########=.......................=##############
################################################
################################################
################################################
(3,6),(3,13)|(4,6),(4,12)|(9,31),(9,32)|(10,13),(10,17)|(11,12),(11,16)|(12,20),(12,29)|(13,17),(13,31)|(14,17),(14,31)|(15,7),(15,10)|(15,20),(15,29)|(16,4),(16,7)|(17,2),(17,4)|(17,11),(17,16)|(18,2),(18,5)|(18,11),(18,16)|(19,5),(19,7)|(20,7),(20,10)|(20,20),(20,29)|(21,17),(21,31)|(22,17),(22,31)|(23,20),(23,29)|(24,10),(24,16)|(25,11),(25,17)|(28,14),(28,17)|(29,11),(29,22)|(29,26),(29,31)|(30,11),(30,21)|(30,27),(30,31)|(31,14),(31,17)|(33,14),(33,17)|(34,11),(34,21)|(34,31),(34,32)|(35,11),(35,22)|(36,14),(36,17)|(38,14),(38,17)|(39,11),(39,26)|(40,11),(40,21)|(40,22),(40,27)|(41,14),(41,17)|(43,5),(43,10)|(44,5),(44,11)|(44,21),(44,22)|
(17,2),(18,2)|(16,4),(17,4)|(18,5),(19,5)|(43,5),(44,5)|(3,6),(4,6)|(15,7),(16,7)|(19,7),(20,7)|(15,10),(20,10)|(24,10),(43,10)|(17,11),(18,11)|(25,11),(29,11)|(30,11),(34,11)|(35,11),(39,11)|(40,11),(44,11)|(4,12),(11,12)|(3,13),(10,13)|(28,14),(31,14)|(33,14),(36,14)|(38,14),(41,14)|(11,16),(17,16)|(18,16),(24,16)|(10,17),(13,17)|(14,17),(21,17)|(22,17),(25,17)|(28,17),(31,17)|(33,17),(36,17)|(38,17),(41,17)|(12,20),(15,20)|(20,20),(23,20)|(30,21),(34,21)|(40,21),(44,21)|(29,22),(35,22)|(40,22),(44,22)|(29,26),(39,26)|(30,27),(40,27)|(12,29),(15,29)|(20,29),(23,29)|(9,31),(13,31)|(14,31),(21,31)|(22,31),(29,31)|(30,31),(34,31)|(9,32),(34,32)|
(11,26),(12,27)|(15,22),(16,23)|(15,22),(19,26)|(15,22),(20,27)|(23,22),(24,23)|
(11,23),(12,22)|(15,27),(16,26)|(15,27),(19,23)|(15,27),(20,22)|(23,27),(24,26)|
