Pièce : LF_A11
taille : 48x35
#########.########..############################
########...########..#######.......#############
########...#######...#######.#####.#############
#######.....#####.....#####...###...############
#######.....#####.....#####...###...############
##=####.....#####.....#####...###...############
##.########################...###...############
##.######.#########.#######...###...############
##..................############################
##############.#############.#####.#############
##############.....................#############
###############################.################
###############################.################
###############################.################
################################################
################################################
################################################
############..........#############..###########
############.########.########............######
############.########.#######..............=####
############.########.....................######
#####=.......###################################
################################################
################################################
################################################
################################################
################################################
################################################
################################################
################################################
################################################
################################################
################################################
################################################
################################################
(2,5),(2,9)|(3,5),(3,8)|(5,21),(5,22)|(7,3),(7,6)|(8,1),(8,3)|(9,0),(9,1)|(9,7),(9,8)|(10,0),(10,1)|(10,7),(10,8)|(11,1),(11,3)|(12,3),(12,6)|(12,17),(12,21)|(13,18),(13,22)|(14,9),(14,11)|(15,9),(15,10)|(17,3),(17,6)|(18,0),(18,1)|(18,2),(18,3)|(19,1),(19,2)|(19,7),(19,8)|(20,0),(20,1)|(20,7),(20,9)|(21,1),(21,3)|(21,18),(21,21)|(22,3),(22,6)|(22,17),(22,20)|(27,3),(27,8)|(28,1),(28,3)|(28,9),(28,10)|(29,2),(29,3)|(29,9),(29,10)|(29,19),(29,20)|(30,3),(30,8)|(30,18),(30,19)|(31,11),(31,14)|(32,11),(32,14)|(33,3),(33,8)|(34,2),(34,3)|(34,9),(34,10)|(35,1),(35,3)|(35,9),(35,11)|(35,17),(35,18)|(36,3),(36,8)|(37,17),(37,18)|(42,18),(42,19)|(42,20),(42,21)|(44,19),(44,20)|
(9,0),(10,0)|(18,0),(20,0)|(8,1),(9,1)|(10,1),(11,1)|(18,1),(19,1)|(20,1),(21,1)|(28,1),(35,1)|(18,2),(19,2)|(29,2),(34,2)|(7,3),(8,3)|(11,3),(12,3)|(17,3),(18,3)|(21,3),(22,3)|(27,3),(28,3)|(29,3),(30,3)|(33,3),(34,3)|(35,3),(36,3)|(2,5),(3,5)|(7,6),(12,6)|(17,6),(22,6)|(9,7),(10,7)|(19,7),(20,7)|(3,8),(9,8)|(10,8),(19,8)|(27,8),(30,8)|(33,8),(36,8)|(2,9),(14,9)|(15,9),(20,9)|(28,9),(29,9)|(34,9),(35,9)|(15,10),(28,10)|(29,10),(34,10)|(14,11),(31,11)|(32,11),(35,11)|(31,14),(32,14)|(12,17),(22,17)|(35,17),(37,17)|(13,18),(21,18)|(30,18),(35,18)|(37,18),(42,18)|(29,19),(30,19)|(42,19),(44,19)|(22,20),(29,20)|(42,20),(44,20)|(5,21),(12,21)|(21,21),(42,21)|(5,22),(13,22)|