Pièce : LF_A12
taille : 48x35
################################################
################################################
################################################
################################################
################=#########=#####################
#####=##########.#########.#####################
#####.##########.#########.#####################
#####.##########.#########.#####################
#####.##########.#########.#####################
#####.##########.#########.#####################
#####.................................##########
################.#########.##########.##########
################+#########+##########.##########
###############.|.#######.|.#########.##########
###############...#######...#########.##########
###############...#######...#########.##########
###############...#######...#########.##########
###############...#######...#########.##########
###############...#######...#########.##########
#####################################.##########
################.#########.##########.##########
###############...#######...#########.##########
###############...#######...#########.##########
###############...#######...#########.##########
###############...#######...#########.##########
#####################################.##########
#####################################.##########
#####################################.##########
#####################################.##########
#####################################.....=#####
################################################
################################################
################################################
################################################
################################################
(5,5),(5,11)|(6,5),(6,10)|(15,13),(15,19)|(15,21),(15,25)|(16,4),(16,10)|(16,11),(16,20)|(16,21),(17,4)|(17,10),(17,11)|(17,20),(17,21)|(18,13),(18,19)|(18,21),(18,25)|(25,13),(25,19)|(25,21),(25,25)|(26,4),(26,10)|(26,11),(26,20)|(26,21),(27,4)|(27,10),(27,11)|(27,20),(27,21)|(28,13),(28,19)|(28,21),(28,25)|(37,11),(37,30)|(38,10),(38,29)|(43,29),(43,30)|
(16,4),(17,4)|(26,4),(27,4)|(5,5),(6,5)|(6,10),(16,10)|(17,10),(26,10)|(27,10),(38,10)|(5,11),(16,11)|(17,11),(26,11)|(27,11),(37,11)|(15,13),(18,13)|(25,13),(28,13)|(15,19),(18,19)|(25,19),(28,19)|(16,20),(17,20)|(26,20),(27,20)|(15,21),(16,21)|(17,21),(18,21)|(25,21),(26,21)|(27,21),(28,21)|(15,25),(18,25)|(25,25),(28,25)|(38,29),(43,29)|(37,30),(43,30)|


