Pièce : LF_A10
taille : 48x35
................................................
................................................
................................................
................................................
................................................
................................................
................................................
................................................
................................................
#/............................................./
##/.........................................../#
####.........................................###
####.........................................###
###...........................................##
###...........................................##
###...........................................##
####................##.......................###
####................##.......................###
####.........................###.............###
###..........##..............#=#..............##
###..........##..............###..............##
###...............|.....................##....##
####..............|.....................##...###
####..............|..........................###
###............##.|..............#............##
####..........#####.............###........#####
#######.....###########.....#######.....########
#######.....###########.....#######.....########
#######.....###########.....#######.....########
########...#############...#########...#########
########..###############.####=#####..##########
##############################.#################
#########.###############.............##########
######=...................###########...=#######
################################################
3,11|46,11|4,11|45,11|3,13|4,13|45,13|46,13|3,16|4,16|20,16|22,16|45,16|46,16|20,18|22,18|3,19|4,19|29,18|32,18|45,19|46,19|13,19|15,19|13,21|15,21|29,21|32,21|40,21|42,21|3,22|4,22|40,23|42,23|45,22|46,22|3,24|4,24|45,24|46,24|15,24|17,24|34,24|33,24|3,25|4,25|14,25|15,25|17,25|32,25|34,25|33,25|35,25|43,25|46,25|4,26|7,26|12,26|14,26|19,26|23,26|28,26|32,26|40,26|43,26|7,29|8,29|11,29|12,29|23,29|24,29|27,29|28,29|35,29|36,29|39,29|40,29|10,30|11,30|24,30|25,30|26,30|27,30|38,30|39,30|8,31|9,32|10,32|10,31|25,32|25,31|26,31|30,32|31,32|36,31|38,32|38,31|9,33|10,33|25,33|38,33|26,33|37,33|26,34|37,34|