Pièce : LF_A17
taille : 54x35
######################################################
######################################################
######################################################
######################################################
######################################################
######################################################
######################################################
######################################################
######################################################
######################################################
######################################################
######################################################
##############.########################.##############
############.....####################.....############
#########.............#.........#..............#######
##########....................................########
#########......................................#######
#########.......................................=#####
#########......................................#######
#########.......................................=#####
##########.....................................#######
#########.....####..............................=#####
#########.....####.............####............#######
########/.....####............#####.............=#####
#######......#####.............####.........##########
#####=........####............#####...#H#H############
#######.......####.............####...#|.|############
#####=........####.............####....+-+.###########
#######.......####.............####....|.|.###########
########/..............................|.|.###########
###########............................|.#############
######################################################
######################################################
######################################################
######################################################
(5,25),(5,26)|(5,27),(5,28)|(7,24),(7,25)|(7,26),(7,27)|(7,28),(7,29)|(9,14),(9,15)|(9,16),(9,20)|(10,15),(10,16)|(10,20),(10,21)|(11,30),(11,31)|(12,13),(12,14)|(13,24),(13,25)|(14,12),(14,13)|(14,21),(14,24)|(14,25),(14,29)|(15,12),(15,13)|(17,13),(17,14)|(18,21),(18,29)|(22,14),(22,15)|(23,14),(23,15)|(30,23),(30,24)|(30,25),(30,26)|(31,22),(31,23)|(31,24),(31,25)|(31,26),(31,29)|(32,14),(32,15)|(33,14),(33,15)|(35,22),(35,29)|(37,13),(37,14)|(38,25),(38,27)|(39,12),(39,13)|(39,25),(39,27)|(40,12),(40,13)|(40,25),(40,26)|(41,25),(41,26)|(41,30),(41,31)|(42,13),(42,14)|(42,25),(42,27)|(43,27),(43,30)|(44,24),(44,25)|(46,15),(46,16)|(47,14),(47,15)|(47,16),(47,17)|(47,18),(47,19)|(47,20),(47,21)|(47,22),(47,23)|(49,17),(49,18)|(49,19),(49,20)|(49,21),(49,22)|(49,23),(49,24)|
(14,14),(15,12)|(39,39),(40,12)|(12,12),(14,13)|(15,15),(17,13)|(37,37),(39,13)|(40,40),(42,13)|(9,9),(12,14)|(17,17),(22,14)|(23,23),(32,14)|(33,33),(37,14)|(42,42),(47,14)|(9,9),(10,15)|(22,22),(23,15)|(32,32),(33,15)|(46,46),(47,15)|(9,9),(10,16)|(46,46),(47,16)|(47,47),(49,17)|(47,47),(49,18)|(47,47),(49,19)|(9,9),(10,20)|(47,47),(49,20)|(9,9),(10,21)|(14,14),(18,21)|(47,47),(49,21)|(31,31),(35,22)|(47,47),(49,22)|(30,30),(31,23)|(47,47),(49,23)|(7,7),(13,24)|(14,14),(30,24)|(31,31),(44,24)|(5,5),(7,25)|(13,13),(14,25)|(30,30),(31,25)|(38,38),(39,25)|(40,40),(41,25)|(42,42),(44,25)|(5,5),(7,26)|(30,30),(31,26)|(40,40),(41,26)|(5,5),(7,27)|(38,38),(39,27)|(42,42),(43,27)|(5,5),(7,28)|(7,7),(14,29)|(18,18),(31,29)|(11,11),(41,30)|(11,11),(41,31)|
(8,29),(9,30)|
(8,24),(9,23)|
(39.5,26),(39.5,31)|(41.5,26),(41.5,30)|

end file : LF_A17