Pièce : LF_B01
taille : 70x78
......................................................................
......................................................................
......................................................................
......................................................................
......................................................................
......................................................................
......................................................................
......................................................................
......................................................................
......................................................................
......................................................................
............................................|.........................
............................................|.........................
............................................|.........................
............................................|.........................
............................................|.........................
............................................|.........................
............................................|.........................
..........................................##H##.......................
........................../#####/.........##=##.......................
..........................#######.......--#####--.....................
..........................#######.........#####.......................
.................###......#######.........#####.......................
.................#=#......#######..........###........................
................-###-.....#######..........###........................
.................###......#######..........###........................
................-###-.....#######.........-###........................
.................###......#######..........###........................
.................###......#######..........###........................
..........................#######..........###........................
..........................#######..........###........................
..........................#######..........###--......................
..........................#######..........###........................
..........................#######..........###........................
..........................#######..........###........................
..........................#######........--###........................
..........................#######..........###........................
..........................#######..........###........................
..........................#######..........###........................
..........................#######..........###........................
..........................#######..........###--......................
..........................#######..........###........................
..........................#######..........###........................
..........................#######..........###........................
..........................#######.........-###........................
..........................#######..........###........................
..........................#######..........###........................
..........................#######..........###........................
..........................#######..........###........................
..........................#######..........###........................
..........................#######..........###--......................
..........................#######..........###........................
..........................#######..........###........................
..........................#######..........###........................
..........................#######..........###........................
..........................#######........--###........................
..........................#######..........###........................
..........................#######..........###........................
..........................#######..........###........................
..........................#######..........###........................
..........................#######..........###--......................
..........................#######..........###........................
..........................#######..........###........................
..........................#######..........###........................
..........................#######..........###........................
..........................#######..........###........................
..........................#######..........###........................
..........................#######..........###........................
.........................########..........###................###....#
......####..............##########........#####..............#########
...#########......?...##############.....########........#############
######################################################################
######################################################################
######################################################################
######################################################################
######################################################################
######################################################################
######################################################################
(3,70),(3,71)|(6,69),(6,70)|(10,69),(10,70)|(12,70),(12,71)|(17,22),(17,29)|(18,23),(18,24)|(19,23),(19,24)|(20,22),(20,29)|(22,70),(22,71)|(24,69),(24,70)|(25,68),(25,69)|(34,69),(34,70)|(36,70),(36,71)|(41,70),(41,71)|(42,18),(42,23)|(42,69),(42,70)|(43,23),(43,69)|(44,18),(44,20)|(45,18),(45,20)|(46,23),(46,69)|(47,18),(47,23)|(47,69),(47,70)|(49,70),(49,71)|(57,70),(57,71)|(61,69),(61,70)|(62,68),(62,69)|(65,68),(65,69)|(69,68),(69,69)|
(42,42),(44,18)|(45,45),(47,18)|(44,44),(45,20)|(17,17),(20,22)|(18,18),(19,23)|(42,42),(43,23)|(46,46),(47,23)|(18,18),(19,24)|(17,17),(20,29)|(25,25),(26,68)|(62,62),(65,68)|(69,69),(70,68)|(6,6),(10,69)|(24,24),(25,69)|(33,33),(34,69)|(42,42),(43,69)|(46,46),(47,69)|(61,61),(62,69)|(65,65),(69,69)|(3,3),(6,70)|(10,10),(12,70)|(22,22),(24,70)|(34,34),(36,70)|(41,41),(42,70)|(47,47),(49,70)|(57,57),(61,70)|(0,0),(3,71)|(12,12),(22,71)|(36,36),(41,71)|(49,49),(57,71)|
(32,19),(33,20)|
(26,20),(27,19)|
(44.5,11),(44.5,18)|
(16,24.5),(16,26.5)|(17,24.5),(17,26.5)|(20,24.5),(20,26.5)|(21,24.5),(21,26.5)|(40,20.5),(41,35.5)|(41,55.5),(42,20.5)|(42,26.5),(42,44.5)|(43,26.5),(43,35.5)|(43,44.5),(43,55.5)|(46,31.5),(46,40.5)|(46,50.5),(46,60.5)|(47,20.5),(48,31.5)|(48,40.5),(48,50.5)|(48,60.5),(49,20.5)|
end file : LF_B01