Pièce : LF_C05
taille : 48x120
################################################
################################################
################################################
################################################
################################################
################################################
################################################
################################################
################################################
################################################
###########.....##.....#..####.....#############
##################.....|..######################
##################.....|..######################
###########............|..######################
##########.............|..######################
##########.............|.............###########
##########.............|.............###########
##########.............|.............###########
##########.............|...........#############
########...............|.....###################
######=................|.....###################
########...............|.....###################
######=................|.....###################
########...............|.....####....###########
#############..........|.....####..#############
#####################..|..######################
#####################..|..######################
#####################..|..######################
#####################..|..######################
#####################..|..######################
#####################..|..######################
#####################..|..######################
#####################..|..######################
#####################..|..######################
#####################..|..######################
#####################..|..######################
#####################..|..######################
#####################..|..######################
#####################..|..######################
#####################..|..######################
#####################..|..######################
#####################..|..######################
#####################..|..######################
#####################..|..######################
#####################..|..######################
#####################..|..######################
#####################..|..######################
#####################..|..######################
#####################..|..######################
#####################..|..######################
#####################..|..######################
#####################..|..######################
#####################..|..######################
#####################..|..######################
#####################..|..######################
#####################..|..######################
#####################..|..######################
#####################..|..######################
#####################..|..######################
#####################..|..######################
#####################..|..######################
#####################..|..######################
#####################..|..######################
#####################..|..######################
#####################..|..######################
#####################..|..######################
#####################..|..######################
#####################..|..######################
#####################..|..######################
#####################..|..######################
#####################..|..######################
#####################..|..######################
#####################..|..######################
#####################..|..######################
#####################..|..######################
#####################..|..######################
#####################..|..######################
#####################..|..######################
#####################..|..######################
#####################..|..######################
#####################..|..######################
#####################..|..######################
#####################..|..######################
#####################..|..######################
#####################..|..######################
#####################..|..######################
#####################..|..######################
#####################..|..######################
#####################..|..######################
#####################..|..######################
#####################..|..######################
#####################..|..######################
#####################..|..######################
#####################..|..######################
#####################..|..######################
#####################..|..######################
#####################..|..######################
#####################..|..######################
#####################..|..######################
#####################..|..######################
#####################..|..######################
#####################..|..######################
#####################..|..######################
#####################..|..######################
#####################..|..######################
#####################..|..######################
#####################..|..######################
#####################..|..######################
#####################..|..######################
#######################|########################
#######################|########################
#######################=########################
################################################
################################################
################################################
################################################
################################################
################################################
################################################
################################################
6,20|6,21|6,22|6,23|8,19|8,20|8,21|8,22|8,23|8,24|10,14|10,19|11,10|11,11|11,13|11,14|13,24|13,25|16,10|16,11|18,10|18,13|21,25|21,109|23,10|23,112|24,10|24,112|26,10|26,15|26,25|26,109|29,19|29,25|30,10|30,11|33,23|33,25|35,10|35,11|35,18|35,19|35,24|35,25|37,15|37,18|37,23|37,24|
(6,20),(6,21)|(6,22),(6,23)|(8,19),(8,20)|(8,21),(8,22)|(8,23),(8,24)|(10,14),(10,19)|(11,10),(11,11)|(11,13),(11,14)|(13,24),(13,25)|(16,10),(16,11)|(18,10),(18,13)|(21,25),(21,109)|(23,10),(23,112)|(24,10),(24,112)|(26,10),(26,15)|(26,25),(26,109)|(29,19),(29,25)|(30,10),(30,11)|(33,23),(33,25)|(35,10),(35,11)|(35,18),(35,19)|(35,24),(35,25)|(37,15),(37,18)|(37,23),(37,24)|
(11,10),(16,10)|(18,10),(23,10)|(24,10),(26,10)|(30,10),(35,10)|(11,11),(16,11)|(30,11),(35,11)|(11,13),(18,13)|(10,14),(11,14)|(26,15),(37,15)|(35,18),(37,18)|(8,19),(10,19)|(29,19),(35,19)|(6,20),(8,20)|(6,21),(8,21)|(6,22),(8,22)|(6,23),(8,23)|(33,23),(37,23)|(8,24),(13,24)|(35,24),(37,24)|(13,25),(21,25)|(26,25),(29,25)|(33,25),(35,25)|(21,109),(26,109)|(23,112),(24,112)|