Pièce : LF_D07
taille : 210x35
..................................................................................................................................................................................................................
..................................................................................................................................................................................................................
..................................................................................................................................................................................................................
..................................................................................................................................................................................................................
..................................................................................................................................................................................................................
..................................................................................................................................................................................................................
..................................................................................................................................................................................................................
..................................................................................................................................................................................................................
.......................###........................................................................................................................................................................................
.......................#=#........................................................................................................................................................................................
......................-###-.......................................................................................................................................................................................
.......................###........................................................................................................................................................................................
......................-###-.......................................................................................................................................................................................
...................................................../#####/................................................................................................................................###...................
.....................................................#######...............................................................................................................................-#=#-..................
.....................................................#######...............................................................................................................|................###...................
#/...................................................#######...............................................................................................................|................###...................
##/..................................................#######...............................................................................................................|......................................
###..................................................#######......................................|..............................|.........................................|.................................../##
###..................................................#######.......|..............................|..............................|.........................................|...................................###
###..................................................#######.......|..............................|........../##/................|.........................................|...................................###
###..................................................#######.......|..............................|........./####/...............|......./#####/...........................|...................................###
###.................................|................#######.......|..............................|.........######...............|.......#######...........................|...................................###
###.................................|................#######.......|..............................|.........######...............|.......#######...........................|...................................###
###......................###........|...............###########....|....................#####.....|.........######...............|.......#######...........................|...................................###
####...............################.?..#####....######################..............##############|.........######...............|.......#######...........................|...................................###
#######..####################################.############################################################..######...............|.......#######...........................|...................................###
########.####################################=##############################=#####################################...............|.......#######......###############......|..................................####
########=##########################################################################################################..............|.#######################=########################.......................########
####################################################################################################################........######################################################################################
######################################################################################################################################################################################################=###########
########################################################################################################################=#########################################################################################
##################################################################################################################################################################################################################
##################################################################################################################################################################################################################
##################################################################################################################################################################################################################
(0,16),(3,25)|(4,25),(4,26)|(7,26),(7,27)|(8,27),(8,29)|(9,26),(9,29)|(19,25),(19,26)|(23,8),(23,13)|(24,9),(24,10)|(25,9),(25,10)|(25,24),(25,25)|(26,8),(26,13)|(28,24),(28,25)|(35,25),(35,26)|(39,25),(39,26)|(44,25),(44,26)|(45,26),(45,28)|(46,26),(46,28)|(48,25),(48,26)|(52,24),(52,25)|(53,24),(60,24)|(63,24),(63,25)|(70,25),(70,26)|(76,27),(76,28)|(77,27),(77,28)|(84,25),(84,26)|(88,24),(88,25)|(93,24),(93,25)|(98,25),(98,26)|(106,26),(106,27)|(108,27),(114,28)|(115,28),(115,29)|(116,29),(116,30)|(120,31),(120,32)|(121,31),(121,32)|(124,29),(124,30)|(131,28),(131,29)|(137,28),(144,28)|(150,27),(150,28)|(154,28),(154,29)|(155,28),(155,29)|(165,27),(165,28)|(179,28),(179,29)|(188,13),(188,17)|(189,14),(189,15)|(190,14),(190,15)|(191,13),(191,17)|(198,30),(198,31)|(199,30),(199,31)|(202,28),(202,29)|(206,27),(206,28)|(207,27),(210,18)|
(23,8),(26,8)|(24,9),(25,9)|(24,10),(25,10)|(23,13),(26,13)|(188,13),(191,13)|(189,14),(190,14)|(189,15),(190,15)|(0,16),(188,17)|(191,17),(210,18)|(25,24),(28,24)|(52,24),(53,24)|(60,24),(63,24)|(88,24),(93,24)|(3,25),(4,25)|(19,25),(25,25)|(28,25),(35,25)|(39,25),(44,25)|(48,25),(52,25)|(63,25),(70,25)|(84,25),(88,25)|(93,25),(98,25)|(4,26),(7,26)|(9,26),(19,26)|(35,26),(39,26)|(44,26),(45,26)|(46,26),(48,26)|(70,26),(84,26)|(98,26),(106,26)|(7,27),(8,27)|(76,27),(77,27)|(106,27),(108,27)|(150,27),(165,27)|(206,27),(207,27)|(45,28),(46,28)|(76,28),(77,28)|(114,28),(115,28)|(131,28),(137,28)|(144,28),(150,28)|(154,28),(155,28)|(165,28),(179,28)|(202,28),(206,28)|(8,29),(9,29)|(115,29),(116,29)|(124,29),(131,29)|(154,29),(155,29)|(179,29),(202,29)|(116,30),(124,30)|(198,30),(199,30)|(120,31),(121,31)|(198,31),(199,31)|(120,32),(121,32)|
(1,16),(3,18)|(59,13),(60,14)|(112,20),(114,22)|(143,21),(144,22)|
(53,14),(54,13)|(108,22),(110,20)|(137,22),(138,21)|(207,19),(208,18)|
(36.5,22),(36.5,25)|(67.5,19),(67.5,25)|(98.5,18),(98.5,26)|(129.5,18),(129.5,29)|(171.5,15),(171.5,28)|
(22,10.5),(22,12.5)|(23,10.5),(23,12.5)|(26,10.5),(26,12.5)|(27,10.5),(27,12.5)|(187,14.5),(188,14.5)|(191,14.5),(192,14.5)|
