Pièce : LF_J01
taille : 276x78
###################################################################################.................................................................................................................................................................................................
####################################################################################................................................................................................................................................................................................
#####################################################################################...............................................................................................................................................................................................
######################################################################################.........../###/..............................................................................................................................................................................
########################################################################################......../#####/.............................................................................................................................................................................
#########################################################################################......#########............................................................................................................................................................................
##########################################################################################......#######.............................................................................................................................................................................
##########################################################################################......#######.............................................................................................................................................................................
###########################################################################################.....#######.............................................................................................................................................................................
#############################################################################################...#######................................................................................................................................................................./########/..
##############################################################################################..#######................................................................................................................................................................/##########/.
########################################################################################################..............................................................................................................................................................##############
################################################################################################.#####................................................................................................................................................................##############
#######################################################################################################................................................................................................................................................................#############
#######################################################################################################................................................................................................................................................................#############
###########################################################################################################............................................................................................................................................................#############
##############################################################################################################........................................................................................................................................................##############
#################################################################################################################.....................................................................................................................................................##############
##################################################################################################################....................................................................................................................................................##############
###################################################################################################################............................................................................................|.......................................................#############
####################################################################################################################............................................................|..............................|.......................................................#############
#####################################################################################################################...........................................................|..............................|.......................................................#############
######################################################################################################################..........................................................|..............................|......................................................##############
#######################################################################################################################.........................................................|..............................|......................................................##############
########################################################################################################################........................................................|..............................|............................#####.....................##############
########################################################################################################################........................................................|..............................|....########.....#####.......########..............#################
#########################################################################################################################.......................................................|............###########################################################........####################
##########################################################################################################################......................................................|.........##############################################################........####################
##########################################################################################################################......................................................|......#################################################################........####################
###########################################################################################################################.....................................................|...####################################################################.......#####################
###########################################################################################################################...................................................##|#######################################################################.......#####################
###########################################################################################################################................................................##############################################################################.....######################
###########################################################################################################################.............................................##################################################################################.##.######################
##########################################################################################################################............................................##############################################################################################################
##########################################################################################################################........................................########################################################################################.##=######################
#########################################################################################################################.....................................###################################################################################=.........#########################
########################################################################################################################.....................................#######################################################################################################################
######################################################################################################################......................................########################################################################################################################
###################################################################################################################.........................................########################################################################################################################
#################################################################################################################...........................................########################################################################################################################
########################.....##################################################################################.............................................########################################################################################################################
#####################.......................#####################.....#######################################..............................................#########################################################################################################################
###################..............................#############........#######################################..............................................#########################################################################################################################
##################..##...............................######...........#######################################..............................................#########################################################################################################################
#################...#######............................##.................................................................................................##########################################################################################################################
######################...................................................................................................................................###########################################################################################################################
######################...................................................................................................................................###########################################################################################################################
####################.....................................................................................................................................###########################################################################################################################
###############...######...............................................................................................................................#############################################################################################################################
###############......................................................................................................................................###############################################################################################################################
##############......................................................................................................................................################################################################################################################################
##############....................................................................................................................................##################################################################################################################################
##############...................................................................................................................................###################################################################################################################################
##############...................................................................................................................................###################################################################################################################################
############......................................................................................................................................##################################################################################################################################
############......................................................................................................................................##################################################################################################################################
############......................................................................................................................................##################################################################################################################################
############......................................................................................................................................##################################################################################################################################
############.....................................................................................................................................###################################################################################################################################
#############....................................................................................................................................###################################################################################################################################
#############...................................................................................................................................####################################################################################################################################
#############.................................................................................................................................######################################################################################################################################
#############................................................................................................................................#######################################################################################################################################
#############..............................................................................................................................#########################################################################################################################################
##############............................................................................................................................##########################################################################################################################################
##############...........................................................................................................................###########################################################################################################################################
###############.........................................................................................................................############################################################################################################################################
#################......................................................................................................................#############################################################################################################################################
####################...................................................................................................................#############################################################################################################################################
##################=##################................................................................................#####............##############################################################################################################################################
##################################=##...................................................####.....................############........###############################################################################################################################################
#########################################..................#######...................###########............########################################################################################################################################################################
###########################################............###############..........#####################..#############################################################################################################################################################################
####################################################################################################################################################################################################################################################################################
####################################################################################################################################################################################################################################################################################
####################################################################################################################################################################################################################################################################################
####################################################################################################################################################################################################################################################################################
####################################################################################################################################################################################################################################################################################
12,54|12,59|13,59|13,64|14,50|14,54|14,64|14,66|15,48|15,50|15,66|15,67|17,44|17,45|17,67|17,68|18,43|18,44|18,48|18,49|18,69|18,70|19,42|19,43|19,69|19,70|20,43|20,45|20,47|20,48|20,68|20,69|21,41|21,42|22,43|22,44|22,45|22,47|24,40|24,41|24,48|24,49|27,44|27,45|29,40|29,41|34,70|34,71|35,70|35,71|37,69|37,71|41,71|41,72|43,72|43,73|44,41|44,42|49,42|49,43|53,43|53,44|55,44|55,45|55,72|55,73|57,44|57,45|59,43|59,44|59,71|59,72|62,42|62,43|65,41|65,42|66,71|66,72|70,41|70,44|70,72|70,73|80,72|80,73|83,0|83,1|84,1|84,2|85,2|85,3|85,71|85,72|86,3|86,4|88,4|88,5|88,70|88,71|89,5|89,6|90,6|90,8|91,8|91,9|92,70|92,71|93,9|93,10|94,10|94,11|95,5|95,6|96,6|96,11|96,12|96,13|96,71|96,72|97,12|97,13|101,72|101,73|102,12|102,13|103,6|103,11|103,13|103,15|103,72|103,73|104,5|104,6|104,11|104,12|107,15|107,16|108,71|108,72|109,41|109,44|110,16|110,17|111,40|111,41|113,17|113,18|113,39|113,40|113,70|113,71|114,18|114,19|115,19|115,20|115,38|115,39|116,20|116,21|117,21|117,22|117,69|117,70|118,22|118,23|118,37|118,38|119,23|119,24|120,24|120,26|120,36|120,37|121,26|121,27|121,35|121,36|122,27|122,29|122,33|122,35|122,69|122,70|123,29|123,33|125,70|125,71|133,70|133,71|134,69|134,70|135,67|135,69|136,66|136,67|137,65|137,66|138,64|138,65|139,63|139,64|141,62|141,63|142,61|142,62|144,60|144,61|145,52|145,54|145,58|145,60|146,51|146,52|146,54|146,58|148,50|148,51|149,49|149,50|151,48|151,49|153,45|153,48|154,44|154,45|155,41|155,44|156,37|156,41|157,36|157,37|158,35|158,36|162,34|162,35|166,33|166,34|168,32|168,33|171,31|171,32|174,30|174,31|180,29|180,30|183,28|183,29|186,27|186,28|189,26|189,27|212,25|212,26|220,25|220,26|225,25|225,26|230,25|230,26|236,24|236,25|237,25|237,26|241,24|241,25|241,35|241,36|245,25|245,26|248,26|248,31|249,31|249,32|250,32|250,33|250,34|250,35|251,32|251,33|251,34|251,36|253,32|253,33|253,34|253,35|254,31|254,33|254,34|254,35|255,29|255,31|256,26|256,29|259,25|259,26|262,11|262,13|262,16|262,19|262,22|262,25|263,13|263,16|263,19|263,22|276,11|
(12,54),(12,59)|(13,59),(13,64)|(14,50),(14,54)|(14,64),(14,66)|(15,48),(15,50)|(15,66),(15,67)|(17,44),(17,45)|(17,67),(17,68)|(18,43),(18,44)|(18,48),(18,49)|(18,69),(18,70)|(19,42),(19,43)|(19,69),(19,70)|(20,43),(20,45)|(20,47),(20,48)|(20,68),(20,69)|(21,41),(21,42)|(22,43),(22,44)|(22,45),(22,47)|(24,40),(24,41)|(24,48),(24,49)|(27,44),(27,45)|(29,40),(29,41)|(34,70),(34,71)|(35,70),(35,71)|(37,69),(37,71)|(41,71),(41,72)|(43,72),(43,73)|(44,41),(44,42)|(49,42),(49,43)|(53,43),(53,44)|(55,44),(55,45)|(55,72),(55,73)|(57,44),(57,45)|(59,43),(59,44)|(59,71),(59,72)|(62,42),(62,43)|(65,41),(65,42)|(66,71),(66,72)|(70,41),(70,44)|(70,72),(70,73)|(80,72),(80,73)|(83,0),(83,1)|(84,1),(84,2)|(85,2),(85,3)|(85,71),(85,72)|(86,3),(86,4)|(88,4),(88,5)|(88,70),(88,71)|(89,5),(89,6)|(90,6),(90,8)|(91,8),(91,9)|(92,70),(92,71)|(93,9),(93,10)|(94,10),(94,11)|(95,5),(95,6)|(96,6),(96,11)|(96,12),(96,13)|(96,71),(96,72)|(97,12),(97,13)|(101,72),(101,73)|(102,12),(102,13)|(103,6),(103,11)|(103,13),(103,15)|(103,72),(103,73)|(104,5),(104,6)|(104,11),(104,12)|(107,15),(107,16)|(108,71),(108,72)|(109,41),(109,44)|(110,16),(110,17)|(111,40),(111,41)|(113,17),(113,18)|(113,39),(113,40)|(113,70),(113,71)|(114,18),(114,19)|(115,19),(115,20)|(115,38),(115,39)|(116,20),(116,21)|(117,21),(117,22)|(117,69),(117,70)|(118,22),(118,23)|(118,37),(118,38)|(119,23),(119,24)|(120,24),(120,26)|(120,36),(120,37)|(121,26),(121,27)|(121,35),(121,36)|(122,27),(122,29)|(122,33),(122,35)|(122,69),(122,70)|(123,29),(123,33)|(125,70),(125,71)|(133,70),(133,71)|(134,69),(134,70)|(135,67),(135,69)|(136,66),(136,67)|(137,65),(137,66)|(138,64),(138,65)|(139,63),(139,64)|(141,62),(141,63)|(142,61),(142,62)|(144,60),(144,61)|(145,52),(145,54)|(145,58),(145,60)|(146,51),(146,52)|(146,54),(146,58)|(148,50),(148,51)|(149,49),(149,50)|(151,48),(151,49)|(153,45),(153,48)|(154,44),(154,45)|(155,41),(155,44)|(156,37),(156,41)|(157,36),(157,37)|(158,35),(158,36)|(162,34),(162,35)|(166,33),(166,34)|(168,32),(168,33)|(171,31),(171,32)|(174,30),(174,31)|(180,29),(180,30)|(183,28),(183,29)|(186,27),(186,28)|(189,26),(189,27)|(212,25),(212,26)|(220,25),(220,26)|(225,25),(225,26)|(230,25),(230,26)|(236,24),(236,25)|(237,25),(237,26)|(241,24),(241,25)|(241,35),(241,36)|(245,25),(245,26)|(248,26),(248,31)|(249,31),(249,32)|(250,32),(250,33)|(250,34),(250,35)|(251,32),(251,33)|(251,34),(251,36)|(253,32),(253,33)|(253,34),(253,35)|(254,31),(254,33)|(254,34),(254,35)|(255,29),(255,31)|(256,26),(256,29)|(259,25),(259,26)|(262,11),(262,13)|(262,16),(262,19)|(262,22),(262,25)|(263,13),(263,16)|(263,19),(263,22)|
(83,0),(83,1)|(84,1),(84,2)|(85,2),(85,3)|(86,3),(86,4)|(88,4),(88,5)|(89,5),(95,5)|(104,5),(89,6)|(90,6),(95,6)|(96,6),(103,6)|(104,6),(90,8)|(91,8),(91,9)|(93,9),(93,10)|(94,10),(94,11)|(96,11),(103,11)|(104,11),(262,11)|(276,11),(96,12)|(97,12),(102,12)|(104,12),(96,13)|(97,13),(102,13)|(103,13),(262,13)|(263,13),(103,15)|(107,15),(107,16)|(110,16),(262,16)|(263,16),(110,17)|(113,17),(113,18)|(114,18),(114,19)|(115,19),(262,19)|(263,19),(115,20)|(116,20),(116,21)|(117,21),(117,22)|(118,22),(262,22)|(263,22),(118,23)|(119,23),(119,24)|(120,24),(236,24)|(241,24),(212,25)|(220,25),(225,25)|(230,25),(236,25)|(237,25),(241,25)|(245,25),(259,25)|(262,25),(120,26)|(121,26),(189,26)|(212,26),(220,26)|(225,26),(230,26)|(237,26),(245,26)|(248,26),(256,26)|(259,26),(121,27)|(122,27),(186,27)|(189,27),(183,28)|(186,28),(122,29)|(123,29),(180,29)|(183,29),(255,29)|(256,29),(174,30)|(180,30),(171,31)|(174,31),(248,31)|(249,31),(254,31)|(255,31),(168,32)|(171,32),(249,32)|(250,32),(251,32)|(253,32),(122,33)|(123,33),(166,33)|(168,33),(250,33)|(251,33),(253,33)|(254,33),(162,34)|(166,34),(250,34)|(251,34),(253,34)|(254,34),(121,35)|(122,35),(158,35)|(162,35),(241,35)|(250,35),(253,35)|(254,35),(120,36)|(121,36),(157,36)|(158,36),(241,36)|(251,36),(118,37)|(120,37),(156,37)|(157,37),(115,38)|(118,38),(113,39)|(115,39),(24,40)|(29,40),(111,40)|(113,40),(21,41)|(24,41),(29,41)|(44,41),(65,41)|(70,41),(109,41)|(111,41),(155,41)|(156,41),(19,42)|(21,42),(44,42)|(49,42),(62,42)|(65,42),(18,43)|(19,43),(20,43)|(22,43),(49,43)|(53,43),(59,43)|(62,43),(17,44)|(18,44),(22,44)|(27,44),(53,44)|(55,44),(57,44)|(59,44),(70,44)|(109,44),(154,44)|(155,44),(17,45)|(20,45),(22,45)|(27,45),(55,45)|(57,45),(153,45)|(154,45),(20,47)|(22,47),(15,48)|(18,48),(20,48)|(24,48),(151,48)|(153,48),(18,49)|(24,49),(149,49)|(151,49),(14,50)|(15,50),(148,50)|(149,50),(146,51)|(148,51),(145,52)|(146,52),(12,54)|(14,54),(145,54)|(146,54),(145,58)|(146,58),(12,59)|(13,59),(144,60)|(145,60),(142,61)|(144,61),(141,62)|(142,62),(139,63)|(141,63),(13,64)|(14,64),(138,64)|(139,64),(137,65)|(138,65),(14,66)|(15,66),(136,66)|(137,66),(15,67)|(17,67),(135,67)|(136,67),(17,68)|(20,68),(18,69)|(19,69),(20,69)|(37,69),(117,69)|(122,69),(134,69)|(135,69),(18,70)|(19,70),(34,70)|(35,70),(88,70)|(92,70),(113,70)|(117,70),(122,70)|(125,70),(133,70)|(134,70),(34,71)|(35,71),(37,71)|(41,71),(59,71)|(66,71),(85,71)|(88,71),(92,71)|(96,71),(108,71)|(113,71),(125,71)|(133,71),(41,72)|(43,72),(55,72)|(59,72),(66,72)|(70,72),(80,72)|(85,72),(96,72)|(101,72),(103,72)|(108,72),(43,73)|(55,73),(70,73)|(80,73),(101,73)|