Pièce : SB_A05
taille : 48x35
################################################
####............################################
##=.............#########################=######
####............#########################|######
###########.....##.......####.......###..|..####
########........##.......####.......###.....####
########........##.......####.......###.....####
########.....#####.......####.......###...######
########........##.......####.......###.....####
########........##.......####.......###.....####
###########.....##.......####.......#####...####
########........##.......####.......###.....####
########.....##########################...######
###.........................................####
#=..........................................####
###......##......................#.....##...####
################################################
################################################
################################################
################################################
################################################
################################################
################################################
################################################
################################################
################################################
################################################
################################################
################################################
################################################
################################################
################################################
################################################
################################################
################################################
16,1|4,2|4,3|18,4|25,4|29,4|36,4|39,4|44,4|4,4|8,5|11,5|11,4|13,8|13,7|16,8|16,7|42,8|42,7|44,8|44,7|8,11|8,10|11,11|11,10|39,11|39,10|41,11|41,10|3,13|8,13|13,13|13,12|16,12|18,12|25,12|29,12|36,12|39,13|42,13|42,12|44,13|44,12|3,14|3,15|9,15|11,15|34,15|33,15|39,15|41,15|3,16|9,16|11,16|34,16|33,16|39,16|41,16|44,16|