Pièce : SB_A02
taille : 48x35
################################################
################################################
################################################
################################################
#############.......................############
####..................................##########
#####..................................#########
#############............................#######
###.......................................######
##........................................######
##.........................................#####
##..........................................####
##...........................................###
##...........................................###
##............................................##
##............................................##
##....................|.......................##
##....................|................|.....###
##....................|................|......=#
##....................|................|.....###
##....................|................|....####
##....................|................|....####
##....................|................|...#####
####/.................|.../######/.....|..######
#####/................|../########/....|..######
######/...............|./##########/...|.#######
#########.............################.|########
################################################
###########=####################################
################################################
################################################
################################################
################################################
################################################
################################################
(2,9),(2,23)|(3,8),(3,9)|(4,5),(4,6)|(5,6),(5,7)|(9,26),(9,27)|(11,28),(11,29)|(12,28),(12,29)|(13,4),(13,5)|(13,7),(13,8)|(22,27),(36,4)|(36,5),(38,5)|(38,6),(38,26)|(38,27),(39,6)|(39,7),(41,7)|(41,8),(41,25)|(41,26),(42,8)|(42,10),(42,23)|(42,25),(43,10)|(43,11),(43,22)|(43,23),(44,11)|(44,12),(44,20)|(44,22),(45,12)|(45,14),(45,17)|(45,18),(45,19)|(45,20),(46,14)|(46,17),(47,18)|
(13,4),(36,4)|(4,5),(13,5)|(36,5),(38,5)|(4,6),(5,6)|(38,6),(39,6)|(5,7),(13,7)|(39,7),(41,7)|(3,8),(13,8)|(41,8),(42,8)|(2,9),(3,9)|(42,10),(43,10)|(43,11),(44,11)|(44,12),(45,12)|(45,14),(46,14)|(45,17),(46,17)|(45,18),(47,18)|(45,19),(47,19)|(44,20),(45,20)|(43,22),(44,22)|(2,23),(42,23)|(43,23),(41,25)|(42,25),(9,26)|(38,26),(41,26)|(9,27),(22,27)|(38,27),(11,28)|(12,28),(11,29)|
(4,23),(7,26)|(33,23),(36,26)|
(24,26),(27,23)|
