Pièce : SB_A12
taille : 48x35
################################################
################################################
###################################..###########
##################################....##########
##################################......########
################################=........=######
##################################......########
###################################....#########
###################################...##########
###################################...##########
####################################..##########
####################################...#########
####################################...#########
####################################...#########
#####################################...########
#####################################...########
######################################...#######
######################################...#######
#######################################..#######
#######################################...######
########################################...#####
########################################....####
########################################....####
#######......################.###########...####
#####..........#########...........######...####
###=.......................................#####
#####.....................................######
#############.........###.#........##..#########
################################################
##################.#############.###############
##################...............###############
################################################
################################################
################################################
################################################
(3,25),(3,26)|(5,24),(5,25)|(5,26),(5,27)|(7,23),(7,24)|(13,23),(13,24)|(13,27),(13,28)|(15,24),(15,25)|(18,29),(18,31)|(19,29),(19,30)|(22,27),(22,28)|(24,24),(24,25)|(25,27),(25,28)|(26,27),(26,28)|(27,27),(27,28)|(29,23),(29,24)|(30,23),(30,24)|(32,5),(32,6)|(32,29),(32,30)|(33,29),(33,31)|(34,3),(34,5)|(34,6),(34,7)|(35,2),(35,3)|(35,7),(35,10)|(35,24),(35,25)|(35,27),(35,28)|(36,10),(36,14)|(37,2),(37,3)|(37,14),(37,16)|(37,27),(37,28)|(38,3),(38,4)|(38,8),(38,11)|(38,16),(38,18)|(39,7),(39,8)|(39,11),(39,14)|(39,18),(39,20)|(39,27),(39,28)|(40,4),(40,5)|(40,6),(40,7)|(40,14),(40,16)|(40,20),(40,23)|(41,16),(41,19)|(41,23),(41,25)|(42,5),(42,6)|(42,19),(42,20)|(42,26),(42,27)|(43,20),(43,21)|(43,25),(43,26)|(44,21),(44,25)|
(35,35),(37,2)|(34,34),(35,3)|(37,37),(38,3)|(38,38),(40,4)|(32,32),(34,5)|(40,40),(42,5)|(32,32),(34,6)|(40,40),(42,6)|(34,34),(35,7)|(39,39),(40,7)|(38,38),(39,8)|(35,35),(36,10)|(38,38),(39,11)|(36,36),(37,14)|(39,39),(40,14)|(37,37),(38,16)|(40,40),(41,16)|(38,38),(39,18)|(41,41),(42,19)|(39,39),(40,20)|(42,42),(43,20)|(43,43),(44,21)|(7,7),(13,23)|(29,29),(30,23)|(40,40),(41,23)|(5,5),(7,24)|(13,13),(15,24)|(24,24),(29,24)|(30,30),(35,24)|(3,3),(5,25)|(15,15),(24,25)|(35,35),(41,25)|(43,43),(44,25)|(3,3),(5,26)|(42,42),(43,26)|(5,5),(13,27)|(22,22),(25,27)|(26,26),(27,27)|(35,35),(37,27)|(39,39),(42,27)|(13,13),(22,28)|(25,25),(26,28)|(27,27),(35,28)|(37,37),(39,28)|(18,18),(19,29)|(32,32),(33,29)|(19,19),(32,30)|(18,18),(33,31)|




end file : SB_A12