Pièce : SB_A06
48x35
-1361x-1026
###...................................##########
###########################################=####
###########################################|####
######................................###..|...#
####=.................................###......#
######................................###......#
##################################....###...####
##################################....###...####
###...................................###......#
###...................................###......#
###...######################################...#
###...######################################...#
###............................................#
###............................................#
################################################
################################################
####...........................############...##
###............................./########/.....#
###............................../######/......#
###................................|..|........#
###................................#..|........#
###................................|..|........#
###................................|..|........#
###...................................|........#
###............................................#
###............................................#
###............................................#
###............................................#
####.................####....................###
#####............#############.............#####
######.........#################.........#######
########....######################....##########
################################################
################################################
################################################
(3,0),(3,1)|(3,8),(3,14)|(3,17),(3,28)|(4,4),(4,5)|(4,16),(4,17)|(4,28),(4,29)|(5,29),(5,30)|(6,3),(6,4)|(6,5),(6,6)|(6,10),(6,12)|(6,30),(6,31)|(8,31),(8,32)|(12,31),(12,32)|(15,30),(15,31)|(17,29),(17,30)|(21,28),(21,29)|(25,28),(25,29)|(30,29),(30,30)|(31,16),(31,17)|(32,30),(32,31)|(34,6),(34,8)|(34,31),(34,32)|(35,20),(35,21)|(36,20),(36,21)|(38,0),(38,1)|(38,3),(38,10)|(38,31),(38,32)|(41,3),(41,10)|(41,30),(41,31)|(43,1),(43,3)|(43,16),(43,17)|(43,29),(43,30)|(44,1),(44,3)|(44,6),(44,8)|(44,10),(44,12)|(45,28),(45,29)|(46,16),(46,17)|(47,3),(47,6)|(47,8),(47,14)|(47,17),(47,28)|
(3,0),(38,0)|(3,1),(38,1)|(43,1),(44,1)|(6,3),(38,3)|(41,3),(43,3)|(44,3),(47,3)|(4,4),(6,4)|(4,5),(6,5)|(6,6),(34,6)|(44,6),(47,6)|(3,8),(34,8)|(44,8),(47,8)|(6,10),(38,10)|(41,10),(44,10)|(6,12),(44,12)|(3,14),(47,14)|(4,16),(31,16)|(43,16),(46,16)|(3,17),(4,17)|(31,17),(43,17)|(46,17),(47,17)|(34,19),(40,19)|(35,20),(36,20)|(35,21),(36,21)|(3,28),(4,28)|(21,28),(25,28)|(45,28),(47,28)|(4,29),(5,29)|(17,29),(21,29)|(25,29),(30,29)|(43,29),(45,29)|(5,30),(6,30)|(15,30),(17,30)|(30,30),(32,30)|(41,30),(43,30)|(6,31),(8,31)|(12,31),(15,31)|(32,31),(34,31)|(38,31),(41,31)|(8,32),(12,32)|(34,32),(38,32)|
(32,17),(34,19)|
(40,19),(42,17)|
(35.5,19),(35.5,20)|(35.5,21),(35.5,23)|(38.5,19),(38.5,24)|(43.5,2),(43.5,4)|

end file : SB_A06