Pièce : SB_B03
taille : 48x78
################################################
################################################
################################################
################################################
##.........................................#####
##.........................................#####
##.........................................#####
##.........................................#####
##.........................................#####
##.........................................#####
##.........................................#####
##.........................................#####
##.........................................#####
##.........................................#####
##.........................................#####
##.........................................#####
##.........................................#####
##.............|.......................|...#####
##.............|.......................|...#####
##.............|.......................|...#####
##.............|.......................|...#####
##.............|.......................|...#####
##.............|...##..................|....=###
##.............|..####.................|...#####
##.............|.######.............../#########
##.............|.######............../##########
##.............|.######............./###########
##.............|.######...##.......#############
##..........####################################
##.............#################################
##.............#################################
##.............#################################
#####..........#################################
##.............#################################
##.............#################################
##.............#################################
##..........####################################
##.............#################################
##.............#################################
##.............#################################
##.............#################################
#####..........#################################
##.............#################################
##.............#################################
##..........####################################
##.............#################################
##..............########...................#####
##...............######....................#####
##...............######....................#####
##/..............######....................#####
###..............######....................#####
###..............######....................#####
###..............######....................#####
###..............######....................#####
###..............######....................#####
###..............######............|.......#####
###..............######............|.......#####
###..............######............|.......#####
#=...............######............|.......#####
###..............######............|.......#####
########.........######............|.......#####
########.........######............|........=###
########.........######............|.......#####
###............/########/..........|...../######
###.........../##########/.........|..../#######
###........../############/........|.../########
#####.......################.......#..##########
################################################
###..........................................###
###..........................................###
################################################
###########################################..###
###########################################..###
################################################
###########################################=####
################################################
################################################
################################################
(1,58),(1,59)|(2,4),(2,32)|(2,33),(2,41)|(2,42),(3,58)|(3,59),(3,60)|(3,63),(3,66)|(3,68),(3,70)|(5,32),(5,33)|(5,41),(5,42)|(5,66),(5,67)|(8,60),(8,63)|(12,28),(12,29)|(12,36),(12,37)|(12,44),(12,45)|(12,66),(12,67)|(15,29),(15,36)|(15,37),(15,44)|(15,45),(15,46)|(16,46),(16,47)|(17,24),(17,28)|(17,47),(17,63)|(18,23),(18,24)|(19,22),(19,23)|(21,22),(21,23)|(22,23),(22,24)|(23,24),(23,28)|(23,47),(23,63)|(24,46),(24,47)|(26,27),(26,28)|(28,27),(28,28)|(28,66),(28,67)|(35,27),(35,28)|(35,67),(36,67)|(38,66),(38,67)|(43,4),(43,22)|(43,23),(43,24)|(43,46),(43,61)|(43,62),(43,63)|(43,71),(43,73)|(43,74),(43,75)|(44,74),(44,75)|(45,22),(45,23)|(45,61),(45,62)|(45,68),(45,70)|(45,71),(45,73)|
(2,4),(43,4)|(19,22),(21,22)|(43,22),(45,22)|(18,23),(19,23)|(21,23),(22,23)|(43,23),(45,23)|(17,24),(18,24)|(22,24),(23,24)|(43,24),(26,27)|(28,27),(35,27)|(12,28),(17,28)|(23,28),(26,28)|(28,28),(35,28)|(12,29),(15,29)|(2,32),(5,32)|(2,33),(5,33)|(12,36),(15,36)|(12,37),(15,37)|(2,41),(5,41)|(2,42),(5,42)|(12,44),(15,44)|(12,45),(15,45)|(15,46),(16,46)|(24,46),(43,46)|(16,47),(17,47)|(23,47),(24,47)|(1,58),(3,58)|(1,59),(3,59)|(3,60),(8,60)|(43,61),(45,61)|(43,62),(45,62)|(3,63),(8,63)|(17,63),(23,63)|(43,63),(3,66)|(5,66),(12,66)|(28,66),(38,66)|(5,67),(12,67)|(28,67),(35,67)|(36,67),(38,67)|(3,68),(45,68)|(3,70),(45,70)|(43,71),(45,71)|(43,73),(45,73)|(43,74),(44,74)|(43,75),(44,75)|