Pièce : SB_C09
taille : 54x120
######################################################
######################################################
######################################################
######################################################
######################################################
######################################################
######################################################
#############################....##..#################
###########################.......#...################
##########################........#....###############
##########################.............###############
#########################..............###############
########################................##############
########################................##############
#################...####.................#############
################.......#.................#############
##############...........................#############
#############................####........###..########
###########...............########.......###...#######
########.................##########.......#.....######
#####=.................############.......#......#####
#######.............###############.......#......#####
###########.......##################.............#####
#####################################............#####
#####################################............#####
######################################............####
######################################............####
######################################............####
#######################################...........####
#######################################..........#####
#######################################..........#####
#######################################..........#####
#######################################.........######
#######################################.........######
#######################################.........######
########################################........######
########################################........######
########################################........######
########################################........######
########################################........######
########################################........######
########################################........######
########################################........######
########################################........######
########################################.......#######
#######################################........#######
#######################################.......########
#######################################.......########
#######################################.......########
#######################################.......########
######################################.......#########
######################################.......#########
######################################......##########
#####################################.......##########
#####################################.......##########
#####################################........#########
####################################.........#########
####################################.........#########
###################################..........#########
###################################..........#########
###################################...........########
##################################............########
##################################.............#######
#################################...............######
################################................######
##############################.................#######
###########################..................#########
#########################................#############
########################.................#############
#######################..........#......##############
######################..........###....###############
#####################.........########################
####################........##########################
###################........###########################
##################......##############################
##################.....###############################
#################.....################################
############..##......################################
###########...##.....#################################
###########....#.....#################################
###########.........##################################
###########.........##################################
###########.........##################################
##########..........##################################
######..##..........##################################
######...#.........###################################
#####....#.........###################################
#####....#.........###################################
#####..............###################################
####...............###################################
####...............###################################
####................##################################
####................##################################
#####................#####....########################
#####..................##.......##.......#############
#####..................#........#...........##########
#####..................#.......................=######
####..........................................########
####........................................##########
####....................................##############
####.......#..........................################
#####.....##.........................#################
######....##........................##################
#######..####............#..........##################
#############...........####......####################
##############........################################
################...###################################
######################################################
######################################################
######################################################
######################################################
######################################################
######################################################
######################################################
######################################################
######################################################
######################################################
######################################################
######################################################
######################################################
4,89|4,93|4,97|4,101|5,20|5,21|5,86|5,89|5,93|5,97|5,101|5,102|6,84|6,86|6,102|6,103|7,21|7,22|7,103|7,104|8,19|8,20|8,84|8,85|9,85|9,88|9,103|9,104|10,83|10,88|10,101|10,103|11,18|11,19|11,22|11,23|11,78|11,83|11,100|11,101|12,77|12,78|12,100|12,103|13,17|13,18|13,103|13,105|14,16|14,17|14,77|14,79|14,105|14,106|15,79|15,80|16,15|16,16|16,77|16,80|16,106|16,107|17,14|17,15|17,76|17,77|18,22|18,23|18,74|18,76|19,73|19,74|19,85|19,91|19,106|19,107|20,14|20,15|20,21|20,22|20,72|20,73|20,80|20,85|20,91|20,93|21,71|21,72|21,78|21,80|21,93|21,94|22,70|22,71|22,76|22,78|22,105|22,106|23,15|23,16|23,20|23,21|23,69|23,70|23,75|23,76|23,94|23,97|24,12|24,16|24,68|24,69|24,74|24,75|24,95|24,97|24,104|24,105|25,11|25,12|25,19|25,20|25,67|25,68|25,94|25,95|25,103|25,104|26,9|26,11|26,18|26,19|26,93|26,94|26,103|26,104|27,8|27,9|27,66|27,67|27,73|27,74|28,72|28,73|28,104|28,105|29,7|29,8|29,17|29,18|30,65|30,66|30,71|30,72|30,93|30,94|32,64|32,65|32,70|32,71|32,94|32,96|33,7|33,8|33,17|33,18|33,63|33,64|33,69|33,70|33,95|33,96|34,8|34,10|34,18|34,19|34,61|34,63|34,69|34,70|34,94|34,95|34,104|34,105|35,7|35,10|35,19|35,22|35,58|35,61|35,70|35,71|36,22|36,23|36,56|36,58|36,102|36,104|37,7|37,8|37,23|37,25|37,53|37,56|37,101|37,102|38,8|38,9|38,25|38,28|38,50|38,53|38,100|38,101|39,9|39,12|39,28|39,35|39,45|39,50|39,70|39,71|40,12|40,14|40,35|40,45|40,69|40,70|40,99|40,100|41,14|41,19|41,67|41,69|41,94|41,95|42,19|42,22|43,19|43,22|44,17|44,19|44,52|44,55|44,95|44,96|44,98|44,99|45,50|45,52|45,55|45,60|45,66|45,67|46,17|46,18|46,46|46,50|46,60|46,62|46,97|46,98|47,18|47,19|47,44|47,46|47,62|47,63|47,65|47,66|48,19|48,20|48,32|48,44|48,63|48,65|48,96|48,97|49,20|49,25|49,29|49,32|50,25|50,29|
(4,89),(4,93)|(4,97),(4,101)|(5,20),(5,21)|(5,86),(5,89)|(5,93),(5,97)|(5,101),(5,102)|(6,84),(6,86)|(6,102),(6,103)|(7,21),(7,22)|(7,103),(7,104)|(8,19),(8,20)|(8,84),(8,85)|(9,85),(9,88)|(9,103),(9,104)|(10,83),(10,88)|(10,101),(10,103)|(11,18),(11,19)|(11,22),(11,23)|(11,78),(11,83)|(11,100),(11,101)|(12,77),(12,78)|(12,100),(12,103)|(13,17),(13,18)|(13,103),(13,105)|(14,16),(14,17)|(14,77),(14,79)|(14,105),(14,106)|(15,79),(15,80)|(16,15),(16,16)|(16,77),(16,80)|(16,106),(16,107)|(17,14),(17,15)|(17,76),(17,77)|(18,22),(18,23)|(18,74),(18,76)|(19,73),(19,74)|(19,85),(19,91)|(19,106),(19,107)|(20,14),(20,15)|(20,21),(20,22)|(20,72),(20,73)|(20,80),(20,85)|(20,91),(20,93)|(21,71),(21,72)|(21,78),(21,80)|(21,93),(21,94)|(22,70),(22,71)|(22,76),(22,78)|(22,105),(22,106)|(23,15),(23,16)|(23,20),(23,21)|(23,69),(23,70)|(23,75),(23,76)|(23,94),(23,97)|(24,12),(24,16)|(24,68),(24,69)|(24,74),(24,75)|(24,95),(24,97)|(24,104),(24,105)|(25,11),(25,12)|(25,19),(25,20)|(25,67),(25,68)|(25,94),(25,95)|(25,103),(25,104)|(26,9),(26,11)|(26,18),(26,19)|(26,93),(26,94)|(26,103),(26,104)|(27,8),(27,9)|(27,66),(27,67)|(27,73),(27,74)|(28,72),(28,73)|(28,104),(28,105)|(29,7),(29,8)|(29,17),(29,18)|(30,65),(30,66)|(30,71),(30,72)|(30,93),(30,94)|(32,64),(32,65)|(32,70),(32,71)|(32,94),(32,96)|(33,7),(33,8)|(33,17),(33,18)|(33,63),(33,64)|(33,69),(33,70)|(33,95),(33,96)|(34,8),(34,10)|(34,18),(34,19)|(34,61),(34,63)|(34,69),(34,70)|(34,94),(34,95)|(34,104),(34,105)|(35,7),(35,10)|(35,19),(35,22)|(35,58),(35,61)|(35,70),(35,71)|(36,22),(36,23)|(36,56),(36,58)|(36,102),(36,104)|(37,7),(37,8)|(37,23),(37,25)|(37,53),(37,56)|(37,101),(37,102)|(38,8),(38,9)|(38,25),(38,28)|(38,50),(38,53)|(38,100),(38,101)|(39,9),(39,12)|(39,28),(39,35)|(39,45),(39,50)|(39,70),(39,71)|(40,12),(40,14)|(40,35),(40,45)|(40,69),(40,70)|(40,99),(40,100)|(41,14),(41,19)|(41,67),(41,69)|(41,94),(41,95)|(42,19),(42,22)|(43,19),(43,22)|(44,17),(44,19)|(44,52),(44,55)|(44,95),(44,96)|(44,98),(44,99)|(45,50),(45,52)|(45,55),(45,60)|(45,66),(45,67)|(46,17),(46,18)|(46,46),(46,50)|(46,60),(46,62)|(46,97),(46,98)|(47,18),(47,19)|(47,44),(47,46)|(47,62),(47,63)|(47,65),(47,66)|(48,19),(48,20)|(48,32),(48,44)|(48,63),(48,65)|(48,96),(48,97)|(49,20),(49,25)|(49,29),(49,32)|(50,25),(50,29)|
(29,7),(33,7)|(35,7),(37,7)|(27,8),(29,8)|(33,8),(34,8)|(37,8),(38,8)|(26,9),(27,9)|(38,9),(39,9)|(34,10),(35,10)|(25,11),(26,11)|(24,12),(25,12)|(39,12),(40,12)|(17,14),(20,14)|(40,14),(41,14)|(16,15),(17,15)|(20,15),(23,15)|(14,16),(16,16)|(23,16),(24,16)|(13,17),(14,17)|(29,17),(33,17)|(44,17),(46,17)|(11,18),(13,18)|(26,18),(29,18)|(33,18),(34,18)|(46,18),(47,18)|(8,19),(11,19)|(25,19),(26,19)|(34,19),(35,19)|(41,19),(42,19)|(43,19),(44,19)|(47,19),(48,19)|(5,20),(8,20)|(23,20),(25,20)|(48,20),(49,20)|(5,21),(7,21)|(20,21),(23,21)|(7,22),(11,22)|(18,22),(20,22)|(35,22),(36,22)|(42,22),(43,22)|(11,23),(18,23)|(36,23),(37,23)|(37,25),(38,25)|(49,25),(50,25)|(38,28),(39,28)|(49,29),(50,29)|(48,32),(49,32)|(39,35),(40,35)|(47,44),(48,44)|(39,45),(40,45)|(46,46),(47,46)|(38,50),(39,50)|(45,50),(46,50)|(44,52),(45,52)|(37,53),(38,53)|(44,55),(45,55)|(36,56),(37,56)|(35,58),(36,58)|(45,60),(46,60)|(34,61),(35,61)|(46,62),(47,62)|(33,63),(34,63)|(47,63),(48,63)|(32,64),(33,64)|(30,65),(32,65)|(47,65),(48,65)|(27,66),(30,66)|(45,66),(47,66)|(25,67),(27,67)|(41,67),(45,67)|(24,68),(25,68)|(23,69),(24,69)|(33,69),(34,69)|(40,69),(41,69)|(22,70),(23,70)|(32,70),(33,70)|(34,70),(35,70)|(39,70),(40,70)|(21,71),(22,71)|(30,71),(32,71)|(35,71),(39,71)|(20,72),(21,72)|(28,72),(30,72)|(19,73),(20,73)|(27,73),(28,73)|(18,74),(19,74)|(24,74),(27,74)|(23,75),(24,75)|(17,76),(18,76)|(22,76),(23,76)|(12,77),(14,77)|(16,77),(17,77)|(11,78),(12,78)|(21,78),(22,78)|(14,79),(15,79)|(15,80),(16,80)|(20,80),(21,80)|(10,83),(11,83)|(6,84),(8,84)|(8,85),(9,85)|(19,85),(20,85)|(5,86),(6,86)|(9,88),(10,88)|(4,89),(5,89)|(19,91),(20,91)|(4,93),(5,93)|(20,93),(21,93)|(26,93),(30,93)|(21,94),(23,94)|(25,94),(26,94)|(30,94),(32,94)|(34,94),(41,94)|(24,95),(25,95)|(33,95),(34,95)|(41,95),(44,95)|(32,96),(33,96)|(44,96),(48,96)|(4,97),(5,97)|(23,97),(24,97)|(46,97),(48,97)|(44,98),(46,98)|(40,99),(44,99)|(11,100),(12,100)|(38,100),(40,100)|(4,101),(5,101)|(10,101),(11,101)|(37,101),(38,101)|(5,102),(6,102)|(36,102),(37,102)|(6,103),(7,103)|(9,103),(10,103)|(12,103),(13,103)|(25,103),(26,103)|(7,104),(9,104)|(24,104),(25,104)|(26,104),(28,104)|(34,104),(36,104)|(13,105),(14,105)|(22,105),(24,105)|(28,105),(34,105)|(14,106),(16,106)|(19,106),(22,106)|(16,107),(19,107)|