Pièce : SB_C09
taille : 54x120
######################################################
######################################################
######################################################
######################################################
######################################################
######################################################
######################################################
#############################....##..#################
###########################.......#...################
##########################........#....###############
##########################.............###############
#########################..............###############
########################................##############
########################................##############
#################...####.................#############
################.......#.................#############
##############...........................#############
#############................####........###..########
###########...............########.......###...#######
########.................##########.......#.....######
#####=.................############.......#......#####
#######.............###############.......#......#####
###########.......##################.............#####
#####################################............#####
#####################################............#####
######################################............####
######################################............####
######################################............####
#######################################...........####
#######################################..........#####
#######################################..........#####
#######################################..........#####
#######################################.........######
#######################################.........######
#######################################.........######
########################################........######
########################################........######
########################################........######
########################################........######
########################################........######
########################################........######
########################################........######
########################################........######
########################################........######
########################################.......#######
#######################################........#######
#######################################.......########
#######################################.......########
#######################################.......########
#######################################.......########
######################################.......#########
######################################.......#########
######################################......##########
#####################################.......##########
#####################################.......##########
#####################################........#########
####################################.........#########
####################################.........#########
###################################..........#########
###################################..........#########
###################################...........########
##################################............########
##################################.............#######
#################################...............######
################################................######
##############################.................#######
###########################..................#########
#########################................#############
########################.................#############
#######################..........#......##############
######################..........###....###############
#####################.........########################
####################........##########################
###################........###########################
##################......##############################
##################.....###############################
#################.....################################
############..##......################################
###########...##.....#################################
###########....#.....#################################
###########.........##################################
###########.........##################################
###########.........##################################
##########..........##################################
######..##..........##################################
######...#.........###################################
#####....#.........###################################
#####....#.........###################################
#####..............###################################
####...............###################################
####...............###################################
####................##################################
####................##################################
#####................#####....########################
#####..................##.......##.......#############
#####..................#........#...........##########
#####..................#.......................=######
####..........................................########
####........................................##########
####....................................##############
####.......#..........................################
#####.....##.........................#################
######....##........................##################
#######..####............#..........##################
#############...........####......####################
##############........################################
################...###################################
######################################################
######################################################
######################################################
######################################################
######################################################
######################################################
######################################################
######################################################
######################################################
######################################################
######################################################
######################################################
######################################################
33,7|35,7|37,7|27,8|29,8|33,8|34,8|37,8|38,8|26,9|27,9|38,9|39,9|35,10|34,10|25,11|26,11|24,12|25,12|39,12|40,12|17,14|20,14|40,14|41,14|16,15|17,15|20,15|23,15|14,16|16,16|24,16|23,16|13,17|14,17|44,17|46,17|11,18|13,18|29,17|33,17|46,18|47,18|8,19|11,19|26,18|29,18|33,18|34,18|41,19|43,19|42,19|44,19|47,19|48,19|8,20|25,19|26,19|34,19|35,19|48,20|49,20|23,20|25,20|7,21|20,21|23,21|43,22|42,22|7,22|11,22|18,22|20,22|35,22|36,22|11,23|18,23|36,23|37,23|49,25|50,25|37,25|38,25|38,28|39,28|49,29|50,29|48,32|49,32|39,35|40,35|39,45|40,45|47,44|48,44|46,46|47,46|38,50|39,50|45,50|46,50|37,53|38,53|44,52|45,52|44,55|45,55|36,56|37,56|35,58|36,58|45,60|46,60|34,61|35,61|46,62|47,62|33,63|34,63|47,63|48,63|32,64|33,64|30,65|32,65|27,66|30,66|47,65|48,65|25,67|27,67|45,66|47,66|24,68|25,68|41,67|45,67|23,69|24,69|22,70|23,70|34,69|33,69|40,69|41,69|21,71|22,71|32,70|34,70|33,70|35,70|39,70|40,70|20,72|21,72|30,71|32,71|35,71|39,71|19,73|20,73|28,72|30,72|18,74|19,74|27,73|28,73|24,74|27,74|17,76|18,76|23,75|24,75|12,77|14,77|16,77|17,77|22,76|23,76|11,78|12,78|14,79|15,79|21,78|22,78|16,80|15,80|20,80|21,80|10,83|11,83|6,84|8,84|8,85|9,85|5,86|6,86|19,85|20,85|10,88|9,88|4,89|5,89|19,91|20,91|20,93|21,93|26,93|30,93|4,93|5,93|21,94|23,94|25,94|26,94|30,94|32,94|34,94|41,94|24,95|25,95|33,95|34,95|41,95|44,95|33,96|32,96|44,96|4,97|5,97|24,97|23,97|46,97|44,98|46,98|40,99|44,99|12,100|11,100|38,100|40,100|4,101|5,101|10,101|11,101|37,101|38,101|5,102|6,102|36,102|37,102|6,103|7,103|9,103|10,103|12,103|13,103|26,103|25,103|7,104|9,104|24,104|26,104|25,104|28,104|34,104|36,104|13,105|14,105|22,105|24,105|28,105|34,105|14,106|16,106|19,106|22,106|16,107|19,107|