Pièce : SB_D06
taille : 48x154
################################################
################################################
################################################
################################################
################################################
################################################
##...........####/............/#################
##.##############..............#################
##.##############..../#|#/.............../######
##.####################=##................######
##.#######################................######
##.####......####..............########...######
##.####.#########..............########...######
##.####.###############################...######
##.####.#################=#=###########...######
##.####.###############################...######
##.####.###############################...######
##.####.###############################...######
##.####.###############################...######
##.####....####.#....#####....#.|.#####...######
##.############......#####......|.........######
##.############........|........|.........######
##.############.......###.......|......../######
##.############........|........|.##############
##.........####.......###.......|.##############
###############......#####......|.####.........#
###############...../#####/.....|.############.#
###############.....#######.....|.############.#
###############......#####......|.############.#
###############......#####......|.############.#
###############......#####......|.####....####.#
###################..#####...############.####.#
###################..#####...############.####.#
###################..#####...############.####.#
###################..#####...############.####.#
###################..#####...############.####.#
###################..#####...############.####.#
###################..#####...############.####.#
###################..#####...############.####.#
###################..#####...############.####.#
###################..#####...###..........####.#
###################..#####...###.#############.#
###################.#######..###.#############.#
###################./#####/..###.#############.#
###################..#####...###.#############.#
###################...###....###.####..........#
###################...###....###.####.##########
###################...###....###.####.##########
###################...###....###.####.##########
###################...###....###.####.##########
###################...###....###.####.##########
###################...###....###.####.##########
###################.../#/....###.####.##########
###################..........###.####.##########
###################..........###.####.##########
###################..........###.####.##########
###################..........########.##########
###################..........########.##########
###################..........########.##########
###################..........########.##########
###################..........###......##########
###################..........###################
###################..........###################
###################..........###################
###################..........###################
###################..........###################
###################..........###################
###################..........###################
###################..........###################
###################..........###################
###################..........###################
###################..........###################
###################..........###################
###################..........###################
###################..........###################
###################..........###################
###################..........###################
###################..........###################
###################..........###################
###################..........###################
###################..........###################
###################..........###################
###################..........###################
###################..........###################
###################..........###################
###################..........###################
###################..........###################
###################..........###################
###################..........###################
###################..........###################
###################..........###################
###################..........###################
###################..........###################
###################..........###################
###################..........###################
###################..........###################
###################..........###################
###################..........###################
###################..........###################
###################..........###################
###################..........###################
###################..........###################
###################..........###################
###################..........###################
###################..........###################
###################..........###################
###################..........###################
###################..........###################
###################..........###################
###################..........###################
###################..........###################
###################..........###################
###################..........###################
###################..........###################
###################..........###################
###################..........###################
###################..........###################
###################..........###################
###################..........###################
###################..........###################
###################..........###################
###################..........###################
###################..........###################
###################..........###################
###################..........###################
###################..........###################
###################..........###################
###################..........###################
###################..........###################
###################..........###################
###################..........###################
###################..........###################
###################..........###################
###################..........###################
###################..........###################
###################..........###################
###################..........###################
################################################
#####################=####=#####################
################################################
################################################
################################################
################################################
################################################
################################################
################################################
################################################
################################################
################################################
################################################
################################################
################################################
################################################
################################################
(2,6),(2,25)|(3,7),(3,24)|(7,11),(7,20)|(8,12),(8,19)|(11,19),(11,20)|(11,24),(11,25)|(13,6),(13,7)|(13,11),(13,12)|(15,19),(15,31)|(16,19),(16,20)|(17,9),(17,11)|(17,13),(17,19)|(17,20),(19,31)|(19,137),(20,28)|(20,42),(21,19)|(21,21),(21,25)|(21,28),(21,42)|(21,45),(21,138)|(21,139),(22,22)|(22,23),(22,24)|(22,25),(22,45)|(22,138),(22,139)|(23,8),(23,10)|(24,8),(24,10)|(25,14),(25,15)|(25,22),(25,23)|(25,24),(25,25)|(25,45),(26,11)|(26,14),(26,15)|(26,19),(26,21)|(26,25),(26,28)|(26,42),(26,45)|(26,138),(26,139)|(27,14),(27,15)|(27,28),(27,42)|(27,138),(27,139)|(28,14),(28,15)|(29,31),(29,137)|(30,19),(30,20)|(31,8),(31,11)|(31,13),(31,19)|(31,20),(32,40)|(32,56),(32,60)|(32,61),(33,41)|(33,56),(34,19)|(34,20),(34,23)|(34,31),(37,45)|(37,60),(38,25)|(38,26),(38,30)|(38,31),(38,46)|(38,61),(39,11)|(39,20),(41,31)|(41,40),(42,30)|(42,41),(46,26)|(46,45),(47,25)|
(2,6),(13,6)|(3,7),(13,7)|(23,8),(24,8)|(31,8),(17,9)|(23,10),(24,10)|(7,11),(13,11)|(17,11),(26,11)|(31,11),(39,11)|(8,12),(13,12)|(17,13),(31,13)|(25,14),(26,14)|(27,14),(28,14)|(25,15),(26,15)|(27,15),(28,15)|(8,19),(11,19)|(15,19),(16,19)|(17,19),(21,19)|(26,19),(30,19)|(31,19),(34,19)|(7,20),(11,20)|(16,20),(17,20)|(30,20),(31,20)|(34,20),(39,20)|(21,21),(26,21)|(22,22),(25,22)|(22,23),(25,23)|(34,23),(3,24)|(11,24),(22,24)|(25,24),(2,25)|(11,25),(21,25)|(22,25),(25,25)|(26,25),(38,25)|(47,25),(38,26)|(46,26),(20,28)|(21,28),(26,28)|(27,28),(38,30)|(42,30),(15,31)|(19,31),(29,31)|(34,31),(38,31)|(41,31),(32,40)|(41,40),(33,41)|(42,41),(20,42)|(21,42),(26,42)|(27,42),(21,45)|(22,45),(25,45)|(26,45),(37,45)|(46,45),(38,46)|(47,46),(32,56)|(33,56),(32,60)|(37,60),(32,61)|(38,61),(19,137)|(29,137),(21,138)|(22,138),(26,138)|(27,138),(21,139)|(22,139),(26,139)|
(20,43),(21,44)|(22,52),(23,53)|(25,8),(26,9)|(26,26),(27,27)|(30,6),(31,7)|(41,8),(42,9)|
(17,7),(18,6)|(20,27),(21,26)|(21,9),(22,8)|(24,53),(25,52)|(26,44),(27,43)|(41,23),(42,22)|
(23.5,8),(23.5,9)|(23.5,21),(23.5,22)|(23.5,23),(23.5,24)|(32.5,19),(32.5,31)|

