Pièce : SB_D04
taille : 48x150
################################################
################################################
################################################
##=#############################################
##|#/......................./###################
#.|...........................|..|.#############
#.|...........................|..|.......#######
#.|...........................+--+........=#####
#.|...........................|..|.....#########
#.|...........................|..|.....#########
#.|..........................##HH###############
#.|..........................##..###############
##H#../#/.../#/........./#/...|..|.....|..|.####
##=#..###...###.../#/...###...+--+.....+--+.####
####../#/.../#/...###.../#/...|..|.....|..|.####
####............../#/.........|..|.....|..|.####
####.........................###########HH######
####.........................###########..######
####...................................|..|.####
####...................................+--+.####
####...|...............................|..|.####
####...|...........|...................|..|.####
####...|...........|.........##HH###############
####...|...........|.........##..##=#=##########
####...|.....|.....|.........##--###############
####/..|.....|.....|.....|../##..###############
#####/.|.....|.....|.....|./###..###############
#######|#####|#####|#####|#####--###############
#######|##=##|##=##|##=##|#####..###############
#######|#####|#####|#####|#####..###############
#######+#####|#####|#####|#####--###############
######.|.###.|.###.|.###.|.###|..|........|.####
######.|.###.|.###.|.###.|.###|..|........|.####
######.|.###.|.###.|.###.|.######H#######.|.####
######.|.###.|.###.|.###.|.##############.|.####
######.|.###.|.###.|.###.|.#########......|.####
######.|.###.|.###.|.###.|.#########......|.####
######.|.###.|.###.|.###.|.#########......|.####
######.|.###.|.###.|.###.|.#########......|.####
######.|.###.|.###.|.###.|.###.####.......|.####
######.|.###.|.###.|.###.|.###.####.......|.####
######.|.###.|.###...###.|.###.#####H#...#######
######.|.###.|.###...###.|.###.#####|#...#######
######.|.###.|.###...###.|.###.####.|.......####
######.|.###.|.###...###.|.###.####.|.......####
######.|.###.|.###...###.|.###.####.|.......####
#######+###/.|./##...##/.|./##.###########..####
#######.###..|..##...##..|..##.###########..####
#######.###.....##...##..|..##.###########..####
#######.###.....##...##.....##.###########..####
#######.###.....##...##.....##........####..####
#######.###.....##...##.....##........####..####
#######.###.....##...##.....##........####..####
#######.###.....##.|.##.....##........####..####
#######.###.....##.|.##.....##........####..####
#######.###/.|./##.|.##.....###.......####..####
#######.####.|.###.|.##..|..##############..####
####....####.|.###.|.##..|..##############..####
####.##.####.|.###.|.##..|..##############..####
####.##.####.|.###.|.##..|..##############..####
#=.........#.|.###.|.##/.|./###.............####
##########.##+#####+####.|.###......############
##########+##.#####.####.|.###/.....############
######/...|.....###.####.|.####/..........|.####
#####/....|.....###.####.|.#####/.........|.####
####/.....|.....###.#####+#########.#####.|.####
####......|.....###.#####.#########.#####.|.####
####......|.....###.#####..............##.|.####
####..../#H#/...###.###############.##.##.|.####
####...###=########......##########.##.##.|.####
####...#################.##########.##.##.|.####
####......|.....########.##########.##.##.|.####
#=........|...........##............##.##.|.####
##########H##########.##.#############.##.|.####
#########.|.#########.##.#############.##.|.####
#########.|.#########.##.#############.##.|.####
#########.|.#########.##.#############.##.|.####
#########.|.#########.##.##............##.|.####
#########.|.#########.##.##.#############.|.####
#########.|.#########+##+##+#############.|.####
####......|..../###..|..|..|.###/.........|.####
####......|...../##..|..|..|.##/..........|.####
####......|......##..|..|....##...........|.####
####..../#H#/....##..|..|....##...../###/.|.####
####....###########..####....#########=##.|.####
####....###########..####....############.|.####
####.............##..........##...|.......|.####
####/............##..........##...|.......|.####
#####/...........##..........##...|.......|.####
########.##########..........#####H#############
########.###=#=####..........###..|..###########
########.##########..........##...|....####.####
##.......##########..........##...|....####.####
##.#####.##########..........##...|....####.####
##.#####.##########..........##...|....####.####
##.##.......####.##..........##...|....####.####
##.##.......####.##..........##...|....####.####
##..........####.##..........##...|....####.####
##.#####H#..####.##..........#####H##..####.####
##.#####|#..####.##..........#####|##..####.####
##.##...|...####.##..........##...|....#########
##.##...|...####.##..........##...|....#########
##.##...|...####.##..........##...|....#########
##......|...####.##..........##...|....#########
#####...|...####.##..........##...|.........####
#######.|...####.##..........##...|.........####
#######.|...####.##..........##...|.........####
#####...|...####.##..........##...|............#
##......|...####.##..........##...|.........##.#
##.##...|...####.##..........##...|.........##.#
##.##..#H##########..###.###.##..###........##.#
##.##..#|#############=###=###############..##.#
##.##...|...##############################..##.#
##.##...|...##############################..##.#
##.##...|...##############################..##.#
##.##...|........##..###.###.##.......####..##.#
##.##...|........##..##..###.##.......####..##.#
##.##...|........##..##..###.##.......####..##.#
##.##...|........##..##..#|#.##.......####..##.#
##.##...|........##..##...|..##.......####..##.#
##.##..#H#.......##..##...|..##.......####..##.#
##.##..#=##############...|..##.##########..##.#
##.##..################...|..##.##########..##.#
##.##............##.......|..##.##########..##.#
##.##............##.......|..##.##########..##.#
##.################.......|..##.####........##.#
##.##########=#=###.......|..##.####...........#
##.################..........##.####........##.#
##.################..........##.####...#######.#
##...............##..........##.####...#######.#
################.##..........##.####........##.#
################.##..........##.####........##.#
##=..............##.......|..##.####...........#
############.######.......|..##.####........####
############.######.......|..##.####...#########
###..............##.......|..##.####...#########
###..............##.......|..##.####........####
#####......########.......|..#########......####
#####......########.......|..#########......####
###----------######.......|..#######--------####
#####......########.......|..#########......####
###..............##.......|..##............#####
###....##........##.......|..##...........######
###..#####.......##.......|..##..........#######
##########################H#####################
###########.###.########=#######=#=#=###########
###=........###.################################
###############.################################
###############=################################
################################################
