Pièce : SB_H03
204x78
-969x738
############################################################################################################################################################################################################
############################################################################################################################################################################################################
##################################################################################################################################=..#######################################################################
####################################################################################################################################...#####################################################################
#########.###########################################################################################################################.....##################################################################
#######=....##########################################################################################################################.....#################################################################
##########....#########################################################################################################################.....################################################################
###########......#######################################################################################################################.......#############################################################
#############......#####################################################################################################################.......#############################################################
##############.......###################################################################################################################......##############################################################
#################..........#############################################################################################################......##############################################################
##################..........###########################################################################################################........#############################################################
###################..........##########################################################################################################........#############################################################
####################...........###################################...###############################################################..........##############################################################
#####################..........##################################........################################################..#######..........################################################################
######################........##################################..........########################################..###......####..........#################################################################
#######################....##H################################..............####################################...........................#################################################################
#######################....##|###############################................###################################...........................#################################################################
######################.......|..#############################..................################################...........................##################################################################
######################.......|....##########################...................###############################............................##################################################################
######################.......|....########################......................##############################...........................###################################################################
#####################........|.....######################........................#########################...#....................|......###################################################################
#####################........|......###################............................#####################..........|....#########..|......###################################################################
###################..........|......##################................#..............##################...........|..###########..|......###################################################################
#################...........###......################............#.######.....................########...........####################...####################################################################
################..........########...################...........###########.....................#####.........######################....####################################################################
################.........##########...=############=............###########..................................####################.|.....####################################################################
###############.........############.################..........#############......................................|...............|....#####################################################################
############........##################################........################...........................##.......|...............|..#######################################################################
######.|............###################################.......##################................#############.....|.............############################################################################
####|..|..........######################################....#########################.......####################..|.......########=#########################################################################
####+--+........#########################################..#######################################################H#########################################################################################
####|..|....#############################################...######################################################=#########################################################################################
#####..|.##################################################..###############################################################################################################################################
#####--####################################################..###############################################################################################################################################
#####..#####################################################.###############################################################################################################################################
#####..#####################################################..##############################################################################################################################################
#####--######################################################.##############################################################################################################################################
#####..######################################################..#############################################################################################################################################
#####..######################################################..#############################################################################################################################################
#####--#######################################################.#############################################################################################################################################
#####..#######################################################..############################################################################################################################################
#####..########################################################.############################################################################################################################################
#####--#######################################################..############################################################################################################################################
###.|..|..####.........................................#######..##########....................##............####..........................##.####.....|..|.............................................#####
##..|..|..###################################################.....######......................##############################################.###############################################################
#...+--+..#################################################...................................##############################################.###############################################################
#...|..|..#################################################.................................................####.............................###############################################################
#......|..#################################################..................................................................................###############################################################
##....................................................................................................................................................#..#................................................##
##........................................................................................................................................................................................................##
##.......................................................................................................................................................................................................###
###.....................................................................................|.|............................................................................................................#####
######........................................................##........................|.|..........................................................................................................#######
####=####...................................................######.....................#H#H#.......................................................................................................#########
################################/......../#################################/......../#################################/.../#################################/...................../#########################
#################################........###################################........###################################...###################################.....................##########################
#################################........###################################........###################################...###################################.....................##########################
#################################........###################################........###################################...###################################.....................##########################
##################################......#####################################......#####################################.#####################################...................###########################
#################################........###################################........###################################...###################################.....................##########################
#################################........###################################........###################################...###################################.....................##########################
###############################............###############################...........################################.......###############################.........................########################
#################################........###################################........###################################...###################################.....................##########################
##################################......#####################################......#####################################.#####################################...................###########################
#####=................/####/................../####/............./####/................../####/............./####/............./####/............./####/.............................../####/......#########
################.....................####........................................................................................................................................................###########
####################..####################################################################################################################.....#############################################################
####=.............................########.................................=#####=...............................#######............................................................................=#######
######################################################################################################....################....#####################################..#######################################
#########################################################################################################..................######################################.............................##############
#################################################################################################################.........##########################################...................#####################
############################################################################################################################################################################################################
#####################################################################################################################=#=##########################################################=#=#######################
############################################################################################################################################################################################################
############################################################################################################################################################################################################
############################################################################################################################################################################################################
############################################################################################################################################################################################################
(1,46),(1,49)|(2,45),(2,46)|(2,49),(2,52)|(3,44),(3,45)|(3,52),(3,53)|(4,30),(4,33)|(4,54),(4,55)|(4,68),(4,69)|(5,33),(5,44)|(5,54),(5,55)|(5,65),(5,66)|(6,29),(6,30)|(6,53),(6,54)|(7,5),(7,6)|(7,34),(7,44)|(9,4),(9,5)|(9,33),(9,34)|(9,54),(9,55)|(10,4),(10,5)|(10,6),(10,7)|(10,44),(10,49)|(11,7),(11,8)|(12,5),(12,6)|(12,28),(12,29)|(12,32),(12,33)|(13,8),(13,9)|(14,6),(14,7)|(14,9),(14,10)|(14,44),(14,45)|(15,27),(15,28)|(16,25),(16,27)|(16,31),(16,32)|(16,66),(16,67)|(17,7),(17,8)|(17,10),(17,11)|(17,24),(17,25)|(18,11),(18,12)|(18,30),(18,31)|(19,8),(19,9)|(19,12),(19,13)|(19,23),(19,24)|(20,13),(20,14)|(20,28),(20,30)|(20,67),(20,68)|(21,9),(21,10)|(21,14),(21,15)|(21,21),(21,23)|(22,15),(22,16)|(22,18),(22,21)|(22,67),(22,68)|(23,16),(23,18)|(24,27),(24,28)|(25,26),(25,27)|(26,25),(26,26)|(27,10),(27,11)|(27,16),(27,18)|(28,11),(28,12)|(28,24),(28,25)|(29,12),(29,13)|(29,16),(29,18)|(30,15),(30,18)|(31,13),(31,15)|(31,24),(31,25)|(31,62),(31,63)|(32,18),(32,19)|(33,56),(33,59)|(33,60),(33,62)|(33,63),(33,64)|(34,19),(34,21)|(34,25),(34,26)|(34,59),(34,60)|(34,64),(34,65)|(34,68),(34,69)|(35,21),(35,22)|(35,26),(35,27)|(36,22),(36,24)|(36,27),(36,28)|(37,24),(37,26)|(37,27),(37,28)|(37,66),(37,67)|(39,26),(39,27)|(40,59),(40,60)|(40,64),(40,65)|(41,56),(41,59)|(41,60),(41,62)|(41,63),(41,64)|(41,66),(41,67)|(42,68),(42,69)|(43,62),(43,63)|(51,26),(51,27)|(53,24),(53,26)|(53,27),(53,28)|(54,23),(54,24)|(54,28),(54,29)|(55,22),(55,23)|(55,29),(55,30)|(55,44),(55,45)|(56,30),(56,31)|(57,21),(57,22)|(57,31),(57,33)|(58,20),(58,21)|(59,31),(59,32)|(59,33),(59,35)|(59,46),(59,49)|(60,19),(60,20)|(60,30),(60,31)|(60,32),(60,33)|(60,35),(60,37)|(60,54),(60,55)|(61,17),(61,19)|(61,33),(61,36)|(61,37),(61,40)|(61,45),(61,46)|(62,16),(62,17)|(62,28),(62,30)|(62,36),(62,38)|(62,40),(62,42)|(62,43),(62,45)|(62,53),(62,54)|(63,27),(63,28)|(63,38),(63,41)|(63,42),(63,43)|(64,15),(64,16)|(64,25),(64,27)|(64,41),(64,45)|(64,53),(64,54)|(65,14),(65,15)|(65,24),(65,25)|(66,13),(66,14)|(66,24),(66,25)|(66,45),(66,46)|(66,54),(66,55)|(67,24),(67,25)|(69,13),(69,14)|(70,23),(70,24)|(71,23),(71,24)|(72,45),(72,46)|(73,14),(73,15)|(73,24),(73,25)|(74,15),(74,16)|(74,44),(74,45)|(74,62),(74,63)|(75,25),(75,27)|(76,16),(76,17)|(76,27),(76,28)|(76,56),(76,59)|(76,60),(76,62)|(76,63),(76,64)|(76,68),(76,69)|(77,17),(77,18)|(77,59),(77,60)|(77,64),(77,65)|(78,28),(78,29)|(79,18),(79,20)|(80,20),(80,21)|(80,29),(80,30)|(81,21),(81,22)|(81,68),(81,69)|(83,22),(83,23)|(83,59),(83,60)|(83,64),(83,65)|(84,56),(84,59)|(84,60),(84,62)|(84,63),(84,64)|(85,23),(85,24)|(85,30),(85,31)|(85,62),(85,63)|(87,54),(87,55)|(88,54),(88,55)|(89,54),(89,55)|(90,54),(90,55)|(91,54),(91,55)|(92,30),(92,31)|(92,54),(92,55)|(94,24),(94,25)|(94,44),(94,47)|(96,25),(96,26)|(96,29),(96,30)|(96,44),(96,45)|(101,25),(101,26)|(102,24),(102,25)|(102,69),(102,70)|(103,23),(103,24)|(104,22),(104,23)|(105,28),(105,29)|(105,70),(105,71)|(106,21),(106,22)|(106,69),(106,70)|(107,28),(107,29)|(108,44),(108,45)|(108,47),(108,48)|(109,21),(109,22)|(109,26),(109,27)|(109,29),(109,30)|(110,19),(110,22)|(110,25),(110,26)|(111,18),(111,19)|(112,16),(112,18)|(112,30),(112,31)|(112,44),(112,45)|(112,47),(112,48)|(113,24),(113,25)|(113,68),(113,69)|(113,71),(113,72)|(114,15),(114,16)|(114,31),(114,33)|(115,31),(115,33)|(116,15),(116,16)|(117,23),(117,24)|(117,62),(117,63)|(117,73),(117,74)|(118,73),(118,74)|(119,15),(119,16)|(119,22),(119,23)|(119,56),(119,59)|(119,60),(119,62)|(119,63),(119,64)|(119,73),(119,74)|(120,59),(120,60)|(120,64),(120,65)|(120,68),(120,69)|(120,73),(120,74)|(121,14),(121,15)|(121,59),(121,60)|(121,64),(121,65)|(122,30),(122,31)|(122,56),(122,59)|(122,60),(122,62)|(122,63),(122,64)|(122,69),(122,70)|(122,71),(122,72)|(123,14),(123,15)|(123,70),(123,71)|(124,62),(124,63)|(125,15),(125,16)|(126,69),(126,70)|(128,22),(128,24)|(128,29),(128,30)|(129,15),(129,16)|(129,26),(129,27)|(130,2),(130,3)|(130,14),(130,15)|(130,30),(130,31)|(131,30),(131,31)|(132,3),(132,4)|(132,13),(132,14)|(132,25),(132,26)|(133,2),(133,3)|(133,4),(133,5)|(133,24),(133,25)|(133,28),(133,29)|(134,5),(134,6)|(135,3),(135,4)|(135,6),(135,7)|(135,11),(135,13)|(135,27),(135,28)|(136,7),(136,11)|(136,24),(136,27)|(137,20),(137,24)|(138,4),(138,5)|(138,18),(138,20)|(138,44),(138,45)|(138,67),(138,68)|(139,5),(139,6)|(139,15),(139,18)|(140,6),(140,7)|(140,14),(140,15)|(140,44),(140,47)|(141,44),(141,49)|(142,9),(142,11)|(142,13),(142,14)|(143,7),(143,9)|(143,11),(143,13)|(143,67),(143,68)|(145,44),(145,45)|(150,49),(150,50)|(151,49),(151,50)|(153,49),(153,50)|(154,49),(154,50)|(155,62),(155,63)|(157,56),(157,59)|(157,60),(157,62)|(157,63),(157,64)|(158,59),(158,60)|(158,64),(158,65)|(161,70),(161,71)|(163,69),(163,70)|(164,71),(164,72)|(165,69),(165,70)|(177,59),(177,60)|(177,64),(177,65)|(178,56),(178,59)|(178,60),(178,62)|(178,63),(178,64)|(178,73),(178,74)|(179,73),(179,74)|(180,62),(180,63)|(180,73),(180,74)|(181,73),(181,74)|(183,71),(183,72)|(190,70),(190,71)|(193,66),(193,67)|(195,54),(195,55)|(195,65),(195,66)|(197,53),(197,54)|(197,68),(197,69)|(199,44),(199,45)|(199,52),(199,53)|(201,51),(201,52)|(202,49),(202,51)|
(130,2),(133,2)|(130,3),(132,3)|(133,3),(135,3)|(9,4),(10,4)|(132,4),(133,4)|(135,4),(138,4)|(7,5),(9,5)|(10,5),(12,5)|(133,5),(134,5)|(138,5),(139,5)|(7,6),(10,6)|(12,6),(14,6)|(134,6),(135,6)|(139,6),(140,6)|(10,7),(11,7)|(14,7),(17,7)|(135,7),(136,7)|(140,7),(143,7)|(11,8),(13,8)|(17,8),(19,8)|(13,9),(14,9)|(19,9),(21,9)|(142,9),(143,9)|(14,10),(17,10)|(21,10),(27,10)|(17,11),(18,11)|(27,11),(28,11)|(135,11),(136,11)|(142,11),(143,11)|(18,12),(19,12)|(28,12),(29,12)|(19,13),(20,13)|(29,13),(31,13)|(66,13),(69,13)|(132,13),(135,13)|(142,13),(143,13)|(20,14),(21,14)|(65,14),(66,14)|(69,14),(73,14)|(121,14),(123,14)|(130,14),(132,14)|(140,14),(142,14)|(21,15),(22,15)|(30,15),(31,15)|(64,15),(65,15)|(73,15),(74,15)|(114,15),(116,15)|(119,15),(121,15)|(123,15),(125,15)|(129,15),(130,15)|(139,15),(140,15)|(22,16),(23,16)|(27,16),(29,16)|(62,16),(64,16)|(74,16),(76,16)|(112,16),(114,16)|(116,16),(119,16)|(125,16),(129,16)|(61,17),(62,17)|(76,17),(77,17)|(22,18),(23,18)|(27,18),(29,18)|(30,18),(32,18)|(77,18),(79,18)|(111,18),(112,18)|(138,18),(139,18)|(32,19),(34,19)|(60,19),(61,19)|(110,19),(111,19)|(58,20),(60,20)|(79,20),(80,20)|(137,20),(138,20)|(21,21),(22,21)|(34,21),(35,21)|(57,21),(58,21)|(80,21),(81,21)|(106,21),(109,21)|(35,22),(36,22)|(55,22),(57,22)|(81,22),(83,22)|(104,22),(106,22)|(109,22),(110,22)|(119,22),(128,22)|(19,23),(21,23)|(54,23),(55,23)|(70,23),(71,23)|(83,23),(85,23)|(103,23),(104,23)|(117,23),(119,23)|(17,24),(19,24)|(28,24),(31,24)|(36,24),(37,24)|(53,24),(54,24)|(65,24),(66,24)|(67,24),(70,24)|(71,24),(73,24)|(85,24),(94,24)|(102,24),(103,24)|(113,24),(117,24)|(128,24),(133,24)|(136,24),(137,24)|(16,25),(17,25)|(26,25),(28,25)|(31,25),(34,25)|(64,25),(65,25)|(66,25),(67,25)|(73,25),(75,25)|(94,25),(96,25)|(101,25),(102,25)|(110,25),(113,25)|(132,25),(133,25)|(25,26),(26,26)|(34,26),(35,26)|(37,26),(39,26)|(51,26),(53,26)|(96,26),(101,26)|(109,26),(110,26)|(129,26),(132,26)|(15,27),(16,27)|(24,27),(25,27)|(35,27),(36,27)|(37,27),(39,27)|(51,27),(53,27)|(63,27),(64,27)|(75,27),(76,27)|(109,27),(129,27)|(135,27),(136,27)|(12,28),(15,28)|(20,28),(24,28)|(36,28),(37,28)|(53,28),(54,28)|(62,28),(63,28)|(76,28),(78,28)|(105,28),(107,28)|(133,28),(135,28)|(6,29),(12,29)|(54,29),(55,29)|(78,29),(80,29)|(96,29),(105,29)|(107,29),(109,29)|(128,29),(133,29)|(4,30),(6,30)|(18,30),(20,30)|(55,30),(56,30)|(60,30),(62,30)|(80,30),(85,30)|(92,30),(96,30)|(109,30),(112,30)|(122,30),(128,30)|(130,30),(131,30)|(16,31),(18,31)|(56,31),(57,31)|(59,31),(60,31)|(85,31),(92,31)|(112,31),(114,31)|(115,31),(122,31)|(130,31),(131,31)|(12,32),(16,32)|(59,32),(60,32)|(4,33),(5,33)|(9,33),(12,33)|(57,33),(59,33)|(60,33),(61,33)|(114,33),(115,33)|(7,34),(9,34)|(59,35),(60,35)|(61,36),(62,36)|(60,37),(61,37)|(62,38),(63,38)|(61,40),(62,40)|(63,41),(64,41)|(62,42),(63,42)|(62,43),(63,43)|(3,44),(5,44)|(7,44),(10,44)|(14,44),(55,44)|(74,44),(94,44)|(96,44),(108,44)|(112,44),(138,44)|(140,44),(141,44)|(145,44),(199,44)|(2,45),(3,45)|(14,45),(55,45)|(61,45),(62,45)|(64,45),(66,45)|(72,45),(74,45)|(96,45),(108,45)|(112,45),(138,45)|(145,45),(199,45)|(1,46),(2,46)|(59,46),(61,46)|(66,46),(72,46)|(94,47),(108,47)|(112,47),(140,47)|(108,48),(112,48)|(1,49),(2,49)|(10,49),(59,49)|(141,49),(150,49)|(151,49),(153,49)|(154,49),(202,49)|(150,50),(151,50)|(153,50),(154,50)|(201,51),(202,51)|(2,52),(3,52)|(199,52),(201,52)|(3,53),(6,53)|(62,53),(64,53)|(197,53),(199,53)|(4,54),(5,54)|(6,54),(9,54)|(60,54),(62,54)|(64,54),(66,54)|(87,54),(88,54)|(89,54),(90,54)|(91,54),(92,54)|(195,54),(197,54)|(4,55),(5,55)|(9,55),(32,55)|(42,55),(60,55)|(66,55),(75,55)|(85,55),(87,55)|(88,55),(89,55)|(90,55),(91,55)|(92,55),(118,55)|(123,55),(156,55)|(179,55),(195,55)|(33,59),(34,59)|(40,59),(41,59)|(76,59),(77,59)|(83,59),(84,59)|(119,59),(120,59)|(121,59),(122,59)|(157,59),(158,59)|(177,59),(178,59)|(33,60),(34,60)|(40,60),(41,60)|(76,60),(77,60)|(83,60),(84,60)|(119,60),(120,60)|(121,60),(122,60)|(157,60),(158,60)|(177,60),(178,60)|(31,62),(33,62)|(41,62),(43,62)|(74,62),(76,62)|(84,62),(85,62)|(117,62),(119,62)|(122,62),(124,62)|(155,62),(157,62)|(178,62),(180,62)|(31,63),(33,63)|(41,63),(43,63)|(74,63),(76,63)|(84,63),(85,63)|(117,63),(119,63)|(122,63),(124,63)|(155,63),(157,63)|(178,63),(180,63)|(33,64),(34,64)|(40,64),(41,64)|(76,64),(77,64)|(83,64),(84,64)|(119,64),(120,64)|(121,64),(122,64)|(157,64),(158,64)|(177,64),(178,64)|(5,65),(34,65)|(40,65),(77,65)|(83,65),(120,65)|(121,65),(158,65)|(177,65),(195,65)|(5,66),(16,66)|(23,66),(27,66)|(37,66),(41,66)|(47,66),(51,66)|(66,66),(70,66)|(90,66),(94,66)|(109,66),(113,66)|(128,66),(132,66)|(147,66),(151,66)|(184,66),(188,66)|(193,66),(195,66)|(16,67),(20,67)|(22,67),(37,67)|(41,67),(138,67)|(143,67),(193,67)|(4,68),(20,68)|(22,68),(34,68)|(42,68),(76,68)|(81,68),(113,68)|(120,68),(138,68)|(143,68),(197,68)|(4,69),(34,69)|(42,69),(76,69)|(81,69),(102,69)|(106,69),(113,69)|(120,69),(122,69)|(126,69),(163,69)|(165,69),(197,69)|(102,70),(105,70)|(106,70),(122,70)|(123,70),(126,70)|(161,70),(163,70)|(165,70),(190,70)|(105,71),(113,71)|(122,71),(123,71)|(161,71),(164,71)|(183,71),(190,71)|(113,72),(122,72)|(164,72),(183,72)|(117,73),(118,73)|(119,73),(120,73)|(178,73),(179,73)|(180,73),(181,73)|(117,74),(118,74)|(119,74),(120,74)|(178,74),(179,74)|(180,74),(181,74)|
(22,65),(23,66)|(32,55),(33,56)|(46,65),(47,66)|(65,65),(66,66)|(75,55),(76,56)|(89,65),(90,66)|(108,65),(109,66)|(118,55),(119,56)|(127,65),(128,66)|(146,65),(147,66)|(156,55),(157,56)|(183,65),(184,66)|
(27,66),(28,65)|(41,56),(42,55)|(51,66),(52,65)|(70,66),(71,65)|(84,56),(85,55)|(94,66),(95,65)|(113,66),(114,65)|(122,56),(123,55)|(132,66),(133,65)|(151,66),(152,65)|(178,56),(179,55)|(188,66),(189,65)|
(4.5,30),(4.5,33)|(4.5,44),(4.5,48)|(7.5,29),(7.5,34)|(7.5,44),(7.5,49)|(29.5,17),(29.5,24)|(88.5,52),(88.5,54)|(90.5,52),(90.5,54)|(114.5,22),(114.5,24)|(114.5,27),(114.5,31)|(130.5,21),(130.5,24)|(130.5,26),(130.5,29)|(150.5,44),(150.5,45)|(153.5,44),(153.5,45)|
(4,31.5),(8,31.5)|(5,34.5),(7,34.5)|(5,37.5),(7,37.5)|(5,40.5),(7,40.5)|(5,43.5),(7,43.5)|(4,46.5),(8,46.5)|
end file : SB_H03