Piece : HI_A15
48x35
-741x183
################################################
################################################
################################################
################################################
################=###############################
################|###############################
###############.|.##############################
###############.|.##############################
###############.|.##############################
###############.|.##############################
###############.|.##############################
###############.|.##############################
###############.|.##############################
###############.|.##############################
###############.|.##############################
###############.|.........................######
###############............................=####
###############...........................######
###############....#############################
###############...##############################
###############...##############################
###############...##############################
###############.|.##############################
###############.|.##############################
###############.|.##############################
###############.|.##############################
###############.|.##############################
###############.|.##############################
###############.|.##############################
################|###############################
################=###############################
################################################
################################################
################################################
################################################
(15,6),(15,29)|(16,4),(16,6)|(16,29),(16,31)|(17,4),(17,6)|(17,29),(17,31)|(18,6),(18,15)|(18,19),(18,29)|(19,18),(19,19)|(42,15),(42,16)|(42,17),(42,18)|(44,16),(44,17)|
(16,4),(17,4)|(15,6),(16,6)|(17,6),(18,6)|(18,15),(42,15)|(42,16),(44,16)|(42,17),(44,17)|(19,18),(42,18)|(18,19),(19,19)|(15,29),(16,29)|(17,29),(18,29)|(16,31),(17,31)|
None|
None|
(16.5,5),(16.5,16)|(16.5,22),(16.5,30)|
None|
end file : HI_A15