Pièce : SS_A16
48x35
-1708x223
################################################
################################################
##############.#################.###############
##############.#################.########=######
##############+#################+########.######
###########...|.................|....####.######
###########...|.................|....####.######
###########...|.................|....####.######
###########...|.../#########/...|....####.######
###########...|...###########...|....####.######
###########...|...###########...|....####.######
###########...|...###########...|....####+######
##...|........|.../#########/...|........|...###
##...|........|....#########....|........|...###
##...|........|....#########....|........|...###
##...|........|....#########....|........|...###
##...|........|....#########....|........|...###
##...|........|....#########....|........|...###
##...|........|....#########....|........|...###
##...|........|.../#########/...|........|...###
#####+########+#################+###############
#####.########.#################.###############
#####.########.#################.###############
#####.########.#################.###############
#####.########.#################.###############
#####.########.#################.###############
#####.########.#################.###############
#####.########..............................=###
#####.##############################.###########
#####.##############################.###########
#####=##############################.###########
################################################
################################################
################################################
################################################
(2,12),(2,20)|(5,20),(5,31)|(6,20),(6,31)|(11,5),(11,12)|(14,2),(14,5)|(14,20),(14,28)|(15,2),(15,5)|(15,20),(15,27)|(18,9),(18,12)|(29,9),(29,12)|(32,2),(32,5)|(32,20),(32,27)|(33,2),(33,5)|(33,20),(33,27)|(36,28),(36,31)|(37,5),(37,12)|(37,28),(37,31)|(41,3),(41,12)|(42,3),(42,12)|(45,12),(45,20)|(45,27),(45,28)|
(14,2),(15,2)|(32,2),(33,2)|(41,3),(42,3)|(11,5),(14,5)|(15,5),(32,5)|(33,5),(37,5)|(19,8),(28,8)|(2,12),(11,12)|(37,12),(41,12)|(42,12),(45,12)|(2,20),(5,20)|(6,20),(14,20)|(15,20),(32,20)|(33,20),(45,20)|(15,27),(32,27)|(33,27),(45,27)|(14,28),(36,28)|(37,28),(45,28)|(5,31),(6,31)|(36,31),(37,31)|
(18,12),(19,13)|(28,8),(29,9)|(28,19),(29,20)|
(18,9),(19,8)|(18,20),(19,19)|(28,13),(29,12)|
(5.5,12),(5.5,21)|(14.5,4),(14.5,21)|(32.5,4),(32.5,21)|(41.5,11),(41.5,20)|
(14,4.5),(15,4.5)|(32,4.5),(33,4.5)|(41,11.5),(42,11.5)|(5,20.5),(6,20.5)|(14,20.5),(15,20.5)|(32,20.5),(33,20.5)|
end file : SS_A16