Pièce : SS_B06
taille : 104x35
########################################################################################################
########################################################################################################
########################################################################################################
########################################################################################################
########################################################################################################
########################################################################################################
########################################################################################################
########################################################################################################
########################################################################################################
##################/........../#########/........../#####################################################
###############................................................###...###################################
###############.................................................|.................................=#####
#####=........+-------..........................................|....###################################
###############.................................................|....###################################
################................................................|....###################################
##################/........../#########/........../########.....|.................................=#####
###########################################################.....|....###################################
###########################################################.....|....###################################
###########################################################.....|....###################################
###########################################################.....|.................................=#####
###########################################################....###...###################################
########################################################################################################
########################################################################################################
########################################################################################################
##################################################################################................=#####
########################################################################################################
########################################################################################################
########################################################################################################
########################################################################################################
########################################################################################################
########################################################################################################
########################################################################################################
########################################################################################################
########################################################################################################
########################################################################################################
(5,12),(5,13)|(15,10),(15,12)|(15,13),(15,14)|(16,14),(16,15)|(59,15),(59,21)|(63,10),(63,11)|(63,20),(63,21)|(66,10),(66,11)|(66,20),(66,21)|(69,10),(69,11)|(69,12),(69,15)|(69,16),(69,19)|(69,20),(69,21)|(82,24),(82,25)|(99,11),(99,12)|(99,15),(99,16)|(99,19),(99,20)|(99,24),(99,25)|
(15,10),(63,10)|(66,10),(69,10)|(63,11),(66,11)|(69,11),(99,11)|(5,12),(15,12)|(69,12),(99,12)|(5,13),(15,13)|(15,14),(16,14)|(16,15),(59,15)|(69,15),(99,15)|(69,16),(99,16)|(69,19),(99,19)|(63,20),(66,20)|(69,20),(99,20)|(59,21),(63,21)|(66,21),(69,21)|(82,24),(99,24)|(82,25),(99,25)|
(18,15),(19,16)|(29,9),(30,10)|(39,15),(40,16)|(50,9),(51,10)|
(18,10),(19,9)|(29,16),(30,15)|(39,10),(40,9)|(50,16),(51,15)|
(64.5,11),(64.5,20)|

