Pièce : SS_I03
taille : 155x120
###########################################################################################################################################################
##############/.|..################|............|.###############################################...|....................#..##########..###################
#############/--+-##################------------+-+.............................................+---+--------------------#--##########--#/#################
############/...|..################|............|.#################.#############################...|....................#..##########..#./################
###########/....|..##########..|...|............|.........#########.###################.............|....................#../########/..#../###############
##########/.....|../########/..|...|............+---------#########.###################-------------+....................#...########...#.../##############
#########/......|...########...#...|......................#########+###################..................................|...########...|..../#############
########/.......|...########...#...|...........................#...|....###......##......................................|...########...|...../############
#######/........|...########...#...|...........................#...|....###......##......................................|...########...|....../###########
######/.........|...########...|...|...........................|...|....###.......|......................................|...########...|......./##########
#####/..........|...########...|...|...........................|...|.....|........|......................................|...########...|......../#########
####/...........|...########...|...|...........................|...|.....|........|......................................|...########...|........./########
###/............|...########...|...............................|...|.....#...............................................|...########...|........../#######
##/.............|...########...|...................................|.....#...............................................|...########...|.........../######
#/..............|...########...|...................................|.....|...............................................|...########...|............/#####
#...............|...########...|...................................|.....|...............................................|../########/..|.............#####
#...............|../########/..|...................................|.....|...............................................|..##########..|.............#####
#...............|..##########..|...................................|.....|...............................................|..##########..|...........|.#####
#...............|..##########..|...................................|.....|...............................................|..##########..|...........|.#####
#...............|..##########..|.........................................#...............................................|../########/..|...........|.#####
#|..............|../########/..|.........................................|...............................................|..............|.........--+-#####
#|..............|..............|.........................................|...............................................|..............|...........#######
#|..............|..............|.........................................|...............................................|..............|...........#######
#|..............|..............|.........................................|..............................................................|...........#######
#|..............|........................................................|..............................................................|...........#######
#|..............|........................................................|..............................................................|...........#######
#|.......................................................................|..........................................................................#######
#|.......................................................................|..........................................................................#######
#|.......................................................................|..........................................................................#######
#|.......................................................................|..........................................................................#######
#|..................................................................|....|..........................................................................#######
#|..................................................................|....|..........................................................................#######
#++.................................................................#....|.......|.............................................................-----+-#####
##|.................................................................|....|.......|..................................................................|.#####
##|.................................................................|....|.......|..................................................................|.#####
##|.................................................................|....|.......|..................................................................|.#####
##|.................................................................|....|.......|..................................................................|.#####
##|.................................................................|....|.......|..................................................................|.#####
##|.................................................................|....|.......|..................................................................|.#####
##|.................................................................#....|.......|....................................................................#####
##|.................................................................#....|...|...|....................................................................#####
##|.................................................................|....|...|...|....................................................................#####
##/.................................................................|....|...|###|.................................................................../#####
###/........................................................|......########..|###|................................................................../######
####/.......................................................+------########--+###+------+........................................................../#######
#####.......................................................|##########################.|..........................................................########
#####.....................................................-++##########################.|..........................................................########
#####......................................................|###########################.|.............................................................#####
#####......................................................|############################+#.....................................................---------###
#####......................................................|############################.#............................................................#####
##########.................................................|############################.#............................................................#####
#############............................................--++###########################.#............................................................#####
#############--------###----------#---......................|###########################.#.........................................................-----###
##########..................................................|###########################+#............................................................#####
####........................................................|##########################||.............................................................#####
####........................................................|##########################++--...........................................................#####
##=---------------..........................................|##########################||.....................................-------------------------=###
####........................................................|############################.............................................................#####
##########..................................................|############################.............................................................#####
##########..................................................|############################.............................................................#####
##########..................................................|##########################||....................................................----------=###
##########..................................................|##########################||.............................................................#####
#####.......................................................|##########################||.............................................................#####
#####.......................................................|##########################|..............................................................#####
#####.....................................................##+##########################|........................................................-------=###
#####.....................................................##.##########################|..............................................................#####
#####.....................................................##+##########################|..............................................................#####
#####.......................................................|##########################|..............................................................#####
#####.......................................................|##########################|...........................................................########
#####.......................................................|##########################|...........................................................########
####/.......................................................+----+..+--###---+####+----+.........................................................../#######
###/.............................................................####..###...|####|................................................................./######
##/..............................................................####..###...+-+--+................................................................../#####
##|................................................................|...###.....|......................................................................#####
###................................................................|....|......|......................................................................#####
###................................................................|....|......|......................................................................#####
###................................................................|....#......|......................................................................#####
##|................................................................|....#......|......................................................................#####
##|................................................................|....|......|....................................................................|.#####
##|................................................................|....|......|....................................................................|.#####
##|................................................................|....|......|....................................................................|.#####
##|................................................................|....|......|....................................................................|.#####
##|................................................................|....#......|....................................................................|.#####
##|...........................|....................................|....|......|........................................................|..........#+######
##|...........................|....................................|...........|........................................................|..........#.######
##|...........................|....................................|...........#........................................................|..........#.######
##|...........................|....................................|...........#........................................................|..........#.######
##|.............|.............|....................................|...........|........................................................|..........#+######
##|.............|.............|....................................|...........|.........................................|..............|...........|.#####
##..............|.............|....................................|...........|.........................................|..............|...........|.#####
##..............|../########/.|....................................|...........|.........................................|..............|...........|.#####
##..............|..##########.|....................................|...........|.........................................|../########/..|...........|.#####
##..............|..##########.|...............|....................|...........|.........................................|..##########..|...........|.#####
##..............|..##########.|...............|....................#...........|.........................................|..##########..|...........|.#####
##..............|../########/.|...............|....................|...........|............................|............|..##########..|...........|.#####
##..............|...########..|...............|....................|...........|............................|............|../########/..|...........|.#####
##..............|...########..|...............|....................|...........|............................|............|...########...|...........|.#####
##/.............|...########..|....|..........|....................|...........|............................#............|...########...|...........|/#####
###/............|...########..|....|..........#....................|....|......|............................|............|...########...|.........../######
####/...........|...########..|....|..........|....................|....|......|............................|......|.....|...########...|........../#######
#####/..........|...########..|....|..........|....................|....|......|............................|......|.....|...########...|........./########
######/.........|...########..|....|..........|....................|....#......|............................|......|.....|...########...|......../#########
#######/........|...########..|....|..........|....................|..######...|............................|......#.....|...########...|......./##########
########/.......|../########/.|....|..........|....................#..######..#+#...........................|......#.....|...########...|....../###########
#########/......|..##########.|....|..........#....................#..######..#.#...........................|......|.....|...########...|...../############
##########/.....|..##########.|....#..........#....................#..######..#.#...........................|......|.....|...########...|..../#############
###########/....|..##########.|....|..........|.............###################.#######.....................|######|.....|../########/..|.../##############
############/...|..##########.|....|..........|.............###################.#######.....................|######|.....|..##########..|../###############
#############/..|..##########.|....|##########|.............###################.#######.....................|######|.....|..##########..|./################
##############/-+--##########-+----############-------------+.........................+---------------------########-----+--##########--+/#################
###############/|..##########.|....|##########|.............#######.###################.....................|######|.....|..##########../##################
###################################################################.#######################################################################################
###################################################################.#######################################################################################
###################################################################.#######################################################################################
###################################################################=#######################################################################################
###########################################################################################################################################################
###########################################################################################################################################################
###########################################################################################################################################################
###########################################################################################################################################################
###########################################################################################################################################################
(1,33),(2,33)|(2,56),(2,57)|(2,74),(2,77)|(3,74),(3,77)|(4,54),(4,56)|(4,57),(4,58)|(5,50),(5,62)|(10,50),(10,51)|(10,53),(10,54)|(10,58),(10,62)|(13,51),(13,53)|(18,2),(18,3)|(19,1),(19,2)|(19,3),(19,111)|(21,52),(21,53)|(24,52),(24,53)|(29,4),(29,111)|(31,6),(31,9)|(32,6),(32,9)|(34,52),(34,53)|(35,1),(35,2)|(35,3),(35,4)|(35,52),(35,53)|(35,105),(35,106)|(35,109),(35,110)|(36,2),(36,3)|(36,105),(36,106)|(36,108),(36,109)|(36,110),(36,111)|(46,98),(46,99)|(46,104),(46,106)|(46,108),(46,109)|(46,110),(46,111)|(47,98),(47,99)|(47,104),(47,106)|(47,109),(47,110)|(50,1),(50,2)|(50,3),(50,4)|(58,4),(58,7)|(58,64),(58,67)|(60,47),(60,51)|(60,64),(60,67)|(60,106),(60,109)|(60,110),(60,111)|(61,45),(61,47)|(61,51),(61,70)|(63,7),(63,9)|(64,7),(64,9)|(65,71),(65,73)|(67,3),(67,7)|(67,43),(67,45)|(67,93),(67,94)|(67,103),(67,106)|(67,110),(67,115)|(68,3),(68,7)|(68,32),(68,33)|(68,39),(68,41)|(68,93),(68,94)|(68,103),(68,106)|(68,110),(68,115)|(69,32),(69,33)|(69,39),(69,41)|(69,71),(69,73)|(70,102),(70,106)|(71,70),(71,74)|(72,7),(72,10)|(72,76),(72,78)|(72,82),(72,83)|(72,101),(72,102)|(73,12),(73,14)|(73,19),(73,20)|(73,76),(73,78)|(73,82),(73,83)|(73,101),(73,102)|(74,12),(74,14)|(74,19),(74,20)|(74,70),(74,74)|(75,7),(75,10)|(75,43),(75,45)|(76,102),(76,106)|(78,42),(78,45)|(78,70),(78,72)|(78,103),(78,106)|(79,85),(79,87)|(79,103),(79,109)|(80,85),(80,87)|(80,103),(80,109)|(81,7),(81,9)|(81,42),(81,45)|(81,103),(81,106)|(82,70),(82,72)|(83,7),(83,9)|(87,4),(87,7)|(87,45),(87,48)|(87,54),(87,57)|(87,60),(87,70)|(87,106),(87,109)|(87,110),(87,111)|(88,48),(88,54)|(89,48),(89,54)|(89,57),(89,60)|(90,48),(90,54)|(97,1),(97,2)|(97,3),(97,4)|(108,97),(108,98)|(108,109),(108,110)|(109,97),(109,98)|(109,106),(109,109)|(109,110),(109,111)|(115,102),(115,104)|(115,106),(115,109)|(115,110),(115,111)|(116,102),(116,104)|(116,109),(116,110)|(121,1),(121,6)|(122,1),(122,6)|(124,1),(124,111)|(134,1),(134,111)|(136,1),(136,6)|(137,6),(147,47)|(147,68),(147,83)|(147,88),(148,21)|(148,32),(148,83)|(148,88),(149,83)|(149,88),(150,21)|(150,32),(150,47)|(150,48),(150,49)|(150,52),(150,53)|(150,56),(150,57)|(150,60),(150,61)|(150,64),(150,65)|(150,68),(150,83)|(150,88),(152,48)|(152,49),(152,52)|(152,53),(152,56)|(152,57),(152,60)|(152,61),(152,64)|
(19,1),(35,1)|(50,1),(97,1)|(121,1),(122,1)|(124,1),(134,1)|(136,1),(18,2)|(19,2),(35,2)|(36,2),(50,2)|(97,2),(18,3)|(19,3),(35,3)|(36,3),(50,3)|(67,3),(68,3)|(97,3),(29,4)|(35,4),(50,4)|(58,4),(87,4)|(97,4),(31,6)|(32,6),(121,6)|(122,6),(136,6)|(137,6),(58,7)|(63,7),(64,7)|(67,7),(68,7)|(72,7),(75,7)|(81,7),(83,7)|(87,7),(31,9)|(32,9),(63,9)|(64,9),(81,9)|(83,9),(72,10)|(75,10),(73,12)|(74,12),(73,14)|(74,14),(73,19)|(74,19),(73,20)|(74,20),(148,21)|(150,21),(68,32)|(69,32),(148,32)|(150,32),(1,33)|(2,33),(68,33)|(69,33),(68,39)|(69,39),(68,41)|(69,41),(78,42)|(81,42),(67,43)|(75,43),(61,45)|(67,45),(75,45)|(78,45),(81,45)|(87,45),(60,47)|(61,47),(147,47)|(150,47),(87,48)|(88,48),(89,48)|(90,48),(150,48)|(152,48),(150,49)|(152,49),(5,50)|(10,50),(10,51)|(13,51),(60,51)|(61,51),(21,52)|(24,52),(34,52)|(35,52),(150,52)|(152,52),(10,53)|(13,53),(21,53)|(24,53),(34,53)|(35,53),(150,53)|(152,53),(4,54)|(10,54),(87,54)|(88,54),(89,54)|(90,54),(2,56)|(4,56),(150,56)|(152,56),(2,57)|(4,57),(87,57)|(89,57),(150,57)|(152,57),(4,58)|(10,58),(87,60)|(89,60),(150,60)|(152,60),(150,61)|(152,61),(5,62)|(10,62),(58,64)|(60,64),(150,64)|(152,64),(150,65)|(152,65),(58,67)|(60,67),(147,68)|(150,68),(61,70)|(71,70),(74,70)|(78,70),(82,70)|(87,70),(65,71)|(69,71),(78,72)|(82,72),(65,73)|(69,73),(2,74)|(3,74),(71,74)|(74,74),(72,76)|(73,76),(2,77)|(3,77),(72,78)|(73,78),(72,82)|(73,82),(72,83)|(73,83),(147,83)|(148,83),(149,83)|(150,83),(79,85)|(80,85),(79,87)|(80,87),(147,88)|(148,88),(149,88)|(150,88),(67,93)|(68,93),(67,94)|(68,94),(108,97)|(109,97),(46,98)|(47,98),(108,98)|(109,98),(46,99)|(47,99),(72,101)|(73,101),(70,102)|(72,102),(73,102)|(76,102),(115,102)|(116,102),(67,103)|(68,103),(78,103)|(79,103),(80,103)|(81,103),(46,104)|(47,104),(115,104)|(116,104),(35,105)|(36,105),(35,106)|(36,106),(46,106)|(47,106),(60,106)|(67,106),(68,106)|(70,106),(76,106)|(78,106),(81,106)|(87,106),(109,106)|(115,106),(36,108)|(46,108),(35,109)|(36,109),(46,109)|(47,109),(60,109)|(79,109),(80,109)|(87,109),(108,109)|(109,109),(115,109)|(116,109),(35,110)|(36,110),(46,110)|(47,110),(60,110)|(67,110),(68,110)|(87,110),(108,110)|(109,110),(115,110)|(116,110),(19,111)|(29,111),(36,111)|(46,111),(60,111)|(87,111),(109,111)|(115,111),(124,111)|(134,111),(67,115)|
(2,42),(5,45)|(2,97),(16,111)|(19,5),(20,6)|(19,20),(20,21)|(19,94),(20,95)|(19,94),(28,103)|(19,94),(29,104)|(28,16),(29,17)|(28,90),(29,91)|(124,4),(125,5)|(124,19),(125,20)|(124,95),(125,96)|(133,15),(134,16)|(133,91),(134,92)|(133,106),(134,107)|(147,70),(150,73)|
(1,15),(15,1)|(2,73),(5,70)|(19,17),(20,16)|(19,91),(20,90)|(19,104),(20,103)|(19,104),(28,95)|(19,104),(29,94)|(28,6),(29,5)|(28,21),(29,20)|(124,16),(125,15)|(124,92),(125,91)|(124,107),(125,106)|(133,5),(134,4)|(133,20),(134,19)|(133,96),(134,95)|(136,111),(150,97)|(147,45),(150,42)|
(1.5,20),(2.5,42)|(2.5,73),(2.5,74)|(2.5,77),(2.5,89)|(16.5,1),(16.5,26)|(16.5,87),(16.5,111)|(30.5,83),(30.5,111)|(31.5,4),(31.5,6)|(31.5,9),(31.5,24)|(35.5,1),(35.5,2)|(35.5,3),(35.5,12)|(35.5,97),(35.5,105)|(35.5,106),(35.5,109)|(35.5,110),(35.5,111)|(46.5,92),(46.5,98)|(46.5,99),(46.5,104)|(46.5,106),(46.5,109)|(46.5,110),(46.5,111)|(48.5,1),(60.5,43)|(63.5,9),(63.5,13)|(67.5,19),(67.5,73)|(67.5,93),(67.5,94)|(67.5,103),(68.5,30)|(68.5,32),(68.5,33)|(68.5,39),(68.5,41)|(68.5,43),(72.5,74)|(72.5,76),(72.5,78)|(72.5,82),(72.5,83)|(72.5,84),(72.5,98)|(72.5,101),(73.5,10)|(73.5,12),(73.5,14)|(73.5,19),(73.5,20)|(73.5,43),(77.5,40)|(79.5,85),(79.5,87)|(81.5,32),(82.5,9)|(82.5,12),(87.5,54)|(87.5,57),(87.5,60)|(88.5,57),(88.5,60)|(88.5,63),(100.5,1)|(108.5,94),(108.5,97)|(108.5,98),(108.5,109)|(108.5,110),(108.5,111)|(115.5,99),(115.5,102)|(115.5,104),(115.5,109)|(115.5,110),(115.5,111)|(121.5,6),(121.5,23)|(121.5,88),(121.5,111)|(136.5,6),(136.5,26)|(136.5,83),(148.5,17)|(148.5,39),(148.5,78)|
(3,56.5),(13,52.5)|(14,2.5),(15,109.5)|(18,2.5),(18,56.5)|(19,109.5),(21,52.5)|(24,52.5),(29,109.5)|(34,52.5),(35,52.5)|(35,109.5),(36,2.5)|(38,52.5),(47,109.5)|(57,51.5),(58,5.5)|(58,46.5),(67,44.5)|(71,70.5),(74,70.5)|(75,44.5),(87,5.5)|(91,55.5),(108,109.5)|(116,109.5),(121,2.5)|(122,2.5),(124,2.5)|(124,109.5),(126,56.5)|(134,2.5),(134,109.5)|(136,2.5),(141,60.5)|(143,32.5),(143,48.5)|(144,64.5),(146,20.5)|(147,52.5),(150,20.5)|(150,32.5),(151,56.5)|(151,60.5),(151,64.5)|(152,48.5),(152,52.5)|
