Pièce : SS_LAB2
48x35
1155x586
################################################
################################################
###########.........############..........######
#########=-........-#######=#=##-----------=####
###########.........#######|#|##..........######
####.|..|..................|.|............######
####.|..|..................|.|............######
####.####.................................|..|.#
####.####.................................|..|.#
####.####.................................|..|.#
####.####.................................####.#
####.####.................................####.#
####.####.................................####.#
####.####.................................####.#
####.|..|.................................####.#
####.|..|.................................####.#
####.|..|.................................####.#
####.|..|.................................|..|.#
####.|..|.................................|..|.#
####.|..|....................................|.#
####.|.......................................|.#
####.|.......................................|.#
####.|.......................................|.#
####.|....................................|..|.#
####.|....................................|..|.#
####.|....................................|..|.#
####.|....................................|..|.#
####.|....................................|..|.#
####.|..|.................................|..|.#
##########................|...............######
##########..........####.#|#####..........######
########=--.......--####.#|#####-----------=####
##########..........####=#=#####..........######
################################################
################################################
(4,5),(4,29)|(5,7),(5,14)|(8,31),(8,32)|(9,3),(9,4)|(9,7),(9,14)|(10,29),(10,31)|(10,32),(10,33)|(11,2),(11,3)|(11,4),(11,5)|(20,2),(20,5)|(20,30),(20,33)|(24,30),(24,33)|(25,30),(25,33)|(26,30),(26,33)|(27,3),(27,5)|(27,30),(27,33)|(28,3),(28,5)|(29,3),(29,5)|(30,3),(30,5)|(32,2),(32,5)|(32,30),(32,33)|(42,2),(42,3)|(42,4),(42,7)|(42,10),(42,17)|(42,29),(42,31)|(42,32),(42,33)|(44,3),(44,4)|(44,31),(44,32)|(46,10),(46,17)|(47,7),(47,29)|
(11,2),(20,2)|(32,2),(42,2)|(9,3),(11,3)|(27,3),(28,3)|(29,3),(30,3)|(42,3),(44,3)|(9,4),(11,4)|(42,4),(44,4)|(4,5),(11,5)|(20,5),(27,5)|(28,5),(29,5)|(30,5),(32,5)|(5,7),(9,7)|(42,7),(47,7)|(42,10),(46,10)|(5,14),(9,14)|(42,17),(46,17)|(4,29),(10,29)|(42,29),(47,29)|(20,30),(24,30)|(25,30),(26,30)|(27,30),(32,30)|(8,31),(10,31)|(42,31),(44,31)|(8,32),(10,32)|(42,32),(44,32)|(10,33),(20,33)|(24,33),(25,33)|(26,33),(27,33)|(32,33),(42,33)|


(5.5,5),(5.5,7)|(5.5,14),(5.5,29)|(8.5,5),(8.5,7)|(8.5,14),(8.5,20)|(8.5,28),(8.5,29)|(26.5,29),(26.5,32)|(27.5,4),(27.5,7)|(29.5,4),(29.5,7)|(42.5,7),(42.5,10)|(42.5,17),(42.5,19)|(42.5,23),(42.5,29)|(45.5,7),(45.5,10)|(45.5,17),(45.5,29)|
(10,3.5),(11,3.5)|(19,3.5),(20,3.5)|(32,3.5),(43,3.5)|(9,31.5),(11,31.5)|(18,31.5),(20,31.5)|(32,31.5),(43,31.5)|
end file : SS_LAB2