Pièce : HI_A17
taille : 54x35
######################################################
######################################################
######################################################
######################################################
###########=##########################################
###########|##########################################
#######....|..###################.####.####.####.#####
#######....|..###################..###.###..###..#####
#######....|..###################..###.###..###..#####
#######....|..###################..###.###..###..#####
######.....|..........|.|..........###.####.###..#####
####=......|..........|.|..........###.###..###..#####
######.....|......................####.###..####.#####
####=......|.......................###.###..###..#####
######.....|.......................###.###..###..#####
#########..#........................|...|....|...#####
#############################.......|...|....|...#####
#############################.......|...|....|....=###
#############################.......|...|....|...#####
#############################.......|...|....|...#####
####=....................####......###.###..###..#####
#############...##..##...####......###.###..###..#####
#######################..####......###.###.#####.#####
######################################################
#######################=#######=#=####################
######################################################
######################################################
######################################################
######################################################
######################################################
######################################################
######################################################
######################################################
######################################################
######################################################
(4,11),(4,12)|(4,13),(4,14)|(4,20),(4,21)|(6,10),(6,11)|(6,12),(6,13)|(6,14),(6,15)|(7,6),(7,10)|(9,15),(9,16)|(11,4),(11,6)|(11,15),(11,16)|(12,4),(12,6)|(12,15),(12,16)|(13,21),(13,22)|(14,6),(14,10)|(16,21),(16,22)|(18,21),(18,22)|(20,21),(20,22)|(22,21),(22,22)|(23,22),(23,23)|(23,24),(23,25)|(24,24),(24,25)|(25,20),(25,23)|(29,16),(29,23)|(31,24),(31,25)|(32,24),(32,25)|(33,6),(33,10)|(33,24),(33,25)|(34,6),(34,7)|(34,12),(34,13)|(34,24),(34,25)|(35,7),(35,12)|(35,13),(35,15)|(35,20),(35,23)|(38,6),(38,15)|(38,20),(38,23)|(39,6),(39,15)|(39,20),(39,23)|(42,7),(42,10)|(42,11),(42,15)|(42,20),(42,23)|(43,6),(43,7)|(43,10),(43,11)|(43,22),(43,23)|(44,6),(44,15)|(44,20),(44,22)|(47,7),(47,12)|(47,13),(47,15)|(47,20),(47,22)|(48,6),(48,7)|(48,12),(48,13)|(48,22),(48,23)|(49,6),(49,17)|(49,18),(49,23)|(51,17),(51,18)|
(11,4),(12,4)|(7,6),(11,6)|(12,6),(14,6)|(33,6),(34,6)|(38,6),(39,6)|(43,6),(44,6)|(48,6),(49,6)|(34,7),(35,7)|(42,7),(43,7)|(47,7),(48,7)|(6,10),(7,10)|(14,10),(33,10)|(42,10),(43,10)|(4,11),(6,11)|(42,11),(43,11)|(4,12),(6,12)|(34,12),(35,12)|(47,12),(48,12)|(4,13),(6,13)|(34,13),(35,13)|(47,13),(48,13)|(4,14),(6,14)|(6,15),(9,15)|(11,15),(12,15)|(35,15),(38,15)|(39,15),(42,15)|(44,15),(47,15)|(9,16),(11,16)|(12,16),(29,16)|(49,17),(51,17)|(49,18),(51,18)|(4,20),(25,20)|(35,20),(38,20)|(39,20),(42,20)|(44,20),(47,20)|(4,21),(13,21)|(16,21),(18,21)|(20,21),(22,21)|(13,22),(16,22)|(18,22),(20,22)|(22,22),(23,22)|(43,22),(44,22)|(47,22),(48,22)|(23,23),(25,23)|(29,23),(35,23)|(38,23),(39,23)|(42,23),(43,23)|(48,23),(49,23)|(23,24),(24,24)|(31,24),(32,24)|(33,24),(34,24)|(23,25),(24,25)|(31,25),(32,25)|(33,25),(34,25)|


(11.5,5),(11.5,15)|(22.5,10),(22.5,12)|(24.5,10),(24.5,12)|(36.5,15),(36.5,20)|(40.5,15),(40.5,20)|(45.5,15),(45.5,20)|

