Pièce : HI_B05
taille : 54x78
######################################################
######################################################
######################################################
##########.......####......####........##..##..#######
##########.......####......####........##..##..#######
##########.......####......####........##..###########
##########.......####......####........##..###########
##########.......####......####........###############
##########.......####......####........###############
######|###.......####......####................#######
#####.|.###......####......####.............##########
#####.|.##.......####......####.............##########
#####...##.......####......####.............##.#######
#####...##.......####......#####...........###.#######
#####...##.......####......######.........############
#####...##.......####......###########################
#####---##-......####......###########################
#####...##.......####......###########################
#####...##.......####......###########################
#####...........######..........#.....#....###########
#####...##......######......................##.#######
#####...##......######......................##.#######
#####---##--....#=##=#......................##.#######
#####...##......#|##|#......................##.#######
#####...##.......|..|.......................##.#######
#####...##..................................##.#######
#####...###.............#...................##.#######
#####...#####..........####.................##.#######
#####---##################################..##-#######
#####...##################################..##.#######
#####......||...........................##..##.#######
#####...................................##..##.#######
#####...............................######..##.#######
#####...............................######..##.#######
#####...............................##......##.#######
#####...............................##......##.#######
#####...............................##.#######.#######
#####...............................##.#######.#######
#####...............................##.##..|...#######
#####..........................#######.##..|...#######
######.........................####.##.##..|...#######
#######........................####.##.##..|...#######
############...................#######.##..|...#######
############........................##.##..|...#######
############........................##.##..|..########
############........................##.###############
#####...####........................##.###############
#####...####........................##.....|......####
#####...####........................######.|.#########
#####...####........................######.|.#########
######..####...............................|.##..#####
############...............................|.#########
############...............................|.#########
############...............................|...#######
############...................................#######
############...................................#######
############..................................########
############...............................###########
############...............................###########
############...............................##..#######
############..............................###..#######
############.............................#############
############............................##############
############...................#######################
############........|..........#######################
############....|...|..........#########..######.#####
############....|...|......###########################
############....|...|......###########################
############....|...|.....................=###########
############....|...|....#############################
##############..|...|...##############################
################H###H#################################
################=#=#=#################################
######################################################
######################################################
######################################################
######################################################
######################################################
(5,10),(5,40)|(5,46),(5,50)|(6,9),(6,10)|(6,40),(6,41)|(6,50),(6,51)|(7,9),(7,10)|(7,41),(7,42)|(8,10),(8,19)|(8,20),(8,30)|(8,46),(8,51)|(10,3),(10,10)|(10,11),(10,19)|(10,20),(10,26)|(11,10),(11,11)|(11,26),(11,27)|(12,42),(12,70)|(13,27),(13,28)|(14,70),(14,71)|(16,19),(16,24)|(16,71),(16,73)|(17,3),(17,19)|(17,22),(17,24)|(17,71),(17,73)|(18,22),(18,24)|(18,72),(18,73)|(19,72),(19,73)|(20,22),(20,24)|(20,71),(20,73)|(21,3),(21,19)|(21,22),(21,24)|(21,71),(21,73)|(22,19),(22,24)|(23,27),(23,28)|(24,26),(24,27)|(24,70),(24,71)|(25,26),(25,27)|(25,69),(25,70)|(27,3),(27,19)|(27,27),(27,28)|(27,66),(27,68)|(31,3),(31,13)|(31,39),(31,43)|(31,63),(31,66)|(32,13),(32,14)|(32,19),(32,20)|(33,14),(33,15)|(33,19),(33,20)|(35,40),(35,42)|(36,32),(36,39)|(36,40),(36,42)|(36,43),(36,50)|(38,19),(38,20)|(38,34),(38,48)|(39,3),(39,9)|(39,19),(39,20)|(39,36),(39,47)|(40,30),(40,32)|(40,62),(40,63)|(40,65),(40,66)|(41,3),(41,7)|(41,38),(41,45)|(41,61),(41,62)|(42,14),(42,15)|(42,28),(42,34)|(42,48),(42,50)|(42,60),(42,61)|(42,65),(42,66)|(43,3),(43,7)|(43,13),(43,14)|(43,19),(43,20)|(43,57),(43,60)|(43,68),(43,69)|(44,10),(44,13)|(44,20),(44,36)|(45,3),(45,5)|(45,48),(45,53)|(45,59),(45,61)|(46,12),(46,14)|(46,20),(46,38)|(46,44),(46,45)|(46,56),(46,57)|(47,3),(47,5)|(47,9),(47,10)|(47,12),(47,14)|(47,20),(47,44)|(47,50),(47,51)|(47,53),(47,56)|(47,59),(47,61)|(48,65),(48,66)|(49,50),(49,51)|(49,65),(49,66)|(50,47),(50,48)|
(10,3),(17,3)|(21,3),(27,3)|(31,3),(39,3)|(41,3),(43,3)|(45,3),(47,3)|(45,5),(47,5)|(41,7),(43,7)|(6,9),(7,9)|(39,9),(47,9)|(5,10),(6,10)|(7,10),(8,10)|(10,10),(11,10)|(44,10),(47,10)|(10,11),(11,11)|(46,12),(47,12)|(31,13),(32,13)|(43,13),(44,13)|(32,14),(33,14)|(42,14),(43,14)|(46,14),(47,14)|(33,15),(42,15)|(8,19),(10,19)|(16,19),(17,19)|(21,19),(22,19)|(27,19),(32,19)|(33,19),(38,19)|(39,19),(43,19)|(8,20),(10,20)|(32,20),(33,20)|(38,20),(39,20)|(43,20),(44,20)|(46,20),(47,20)|(17,22),(18,22)|(20,22),(21,22)|(16,24),(17,24)|(18,24),(20,24)|(21,24),(22,24)|(10,26),(11,26)|(24,26),(25,26)|(11,27),(13,27)|(23,27),(24,27)|(25,27),(27,27)|(13,28),(23,28)|(27,28),(42,28)|(8,30),(40,30)|(36,32),(40,32)|(38,34),(42,34)|(39,36),(44,36)|(41,38),(46,38)|(31,39),(36,39)|(5,40),(6,40)|(35,40),(36,40)|(6,41),(7,41)|(7,42),(12,42)|(35,42),(36,42)|(31,43),(36,43)|(46,44),(47,44)|(41,45),(46,45)|(5,46),(8,46)|(39,47),(50,47)|(38,48),(42,48)|(45,48),(50,48)|(5,50),(6,50)|(36,50),(42,50)|(47,50),(49,50)|(6,51),(8,51)|(47,51),(49,51)|(45,53),(47,53)|(46,56),(47,56)|(43,57),(46,57)|(45,59),(47,59)|(42,60),(43,60)|(41,61),(42,61)|(45,61),(47,61)|(40,62),(41,62)|(31,63),(40,63)|(40,65),(42,65)|(48,65),(49,65)|(27,66),(31,66)|(40,66),(42,66)|(48,66),(49,66)|(27,68),(43,68)|(25,69),(43,69)|(12,70),(14,70)|(24,70),(25,70)|(14,71),(16,71)|(17,71),(20,71)|(21,71),(24,71)|(18,72),(19,72)|(16,73),(17,73)|(18,73),(19,73)|(20,73),(21,73)|


(6.5,9),(6.5,12)|(11.5,30),(11.5,31)|(12.5,30),(12.5,31)|(16.5,65),(16.5,71)|(17.5,23),(17.5,25)|(20.5,23),(20.5,25)|(20.5,64),(20.5,71)|(43.5,38),(43.5,45)|(43.5,47),(43.5,54)|
(5,16.5),(5,22.5)|(5,28.5),(8,16.5)|(8,22.5),(8,28.5)|(10,16.5),(10,22.5)|(11,16.5),(12,22.5)|(46,28.5),(47,28.5)|
