Pièce : DS_A20
48x35
-196x9
################################################
################################################
################################################
################################################
################################################
################################################
################################################
################################################
################################################
############.....|........|...|.....############
##########.......|........|...|......###########
#########........|........|...|........#########
#########........|........|...|........#########
#########........|........|...|........#########
#########........##########...##################
#########..............................#########
#######=...............................#########
#########..............................#########
#########..............................#########
##########...........###/............./#########
##########.........##########/.......###########
################################...#############
################################...#############
################################...#############
################################...#############
################################...#############
################################.|.#############
################################.|.#############
################################.|.#############
################################.|.#############
#################################H##############
#################################=##############
################################################
################################################
################################################
(7,16),(7,17)|(9,11),(9,16)|(9,17),(9,19)|(10,10),(10,11)|(10,19),(10,21)|(12,9),(12,10)|(17,14),(17,15)|(19,20),(19,21)|(21,19),(21,20)|(27,14),(27,15)|(30,14),(30,15)|(32,21),(32,30)|(33,30),(33,32)|(34,30),(34,32)|(35,21),(35,30)|(36,9),(36,10)|(37,10),(37,11)|(37,20),(37,21)|(39,11),(39,14)|
(12,9),(36,9)|(10,10),(12,10)|(36,10),(37,10)|(9,11),(10,11)|(37,11),(39,11)|(17,14),(27,14)|(30,14),(39,14)|(17,15),(27,15)|(30,15),(39,15)|(7,16),(9,16)|(7,17),(9,17)|(9,19),(10,19)|(21,19),(24,19)|(19,20),(21,20)|(29,20),(37,20)|(10,21),(19,21)|(32,21),(35,21)|(32,30),(33,30)|(34,30),(35,30)|(33,32),(34,32)|
(24,19),(25,20)|(29,20),(30,21)|
(38,20),(39,19)|
(17.5,9),(17.5,14)|(26.5,9),(26.5,14)|(30.5,9),(30.5,14)|(33.5,26),(33.5,30)|

end file : DS_A20