Piece : DS_A16
48x35
40x2
################################################
################################################
#####=##########################################
#####|################......####################
####.|....############......####################
#....|...................................#######
#....|.........................................#
#....|.........................................#
#####H#................./#/....................#
#....|........../#/.....###...../#/.....###....#
#....|..........###...../#/.....###.....#=#....#
#....|........../#/............./#/.....###....#
##...|................................../#/....#
###..|.........................................#
#####H###.....................................##
#####=#########......###.....................###
###########.####################################
###########.####################################
###########.####################################
###########.####################################
###########..................................###
###############...............................##
###############/...............................#
################/..............................#
#################/.............................#
##################/............................#
###################/...........................#
####################/..........................#
#####################/.........................#
######################/........................#
#######################/.....................###
########################/####............#######
################################################
##################################=#=#=#########
################################################
(1,5),(1,8)|(1,9),(1,12)|(2,12),(2,13)|(3,13),(3,14)|(4,4),(4,5)|(5,2),(5,4)|(5,8),(5,9)|(5,14),(5,16)|(6,2),(6,4)|(6,8),(6,9)|(6,14),(6,16)|(7,8),(7,9)|(9,14),(9,15)|(10,4),(10,5)|(11,16),(11,21)|(12,16),(12,20)|(15,15),(15,16)|(16,10),(16,11)|(19,10),(19,11)|(21,15),(21,16)|(22,3),(22,5)|(24,9),(24,10)|(24,15),(24,16)|(27,9),(27,10)|(28,3),(28,5)|(29,31),(29,32)|(32,10),(32,11)|(34,33),(34,34)|(35,10),(35,11)|(35,33),(35,34)|(36,33),(36,34)|(37,33),(37,34)|(38,33),(38,34)|(39,33),(39,34)|(40,9),(40,12)|(41,5),(41,6)|(41,10),(41,11)|(41,31),(41,32)|(42,10),(42,11)|(43,9),(43,12)|(45,15),(45,16)|(45,20),(45,21)|(45,30),(45,31)|(46,14),(46,15)|(46,21),(46,22)|(47,6),(47,14)|(47,22),(47,30)|
(5,2),(6,2)|(22,3),(28,3)|(4,4),(5,4)|(6,4),(10,4)|(1,5),(4,5)|(10,5),(22,5)|(28,5),(41,5)|(41,6),(47,6)|(1,8),(5,8)|(6,8),(7,8)|(25,8),(26,8)|(1,9),(5,9)|(6,9),(7,9)|(17,9),(18,9)|(33,9),(34,9)|(40,9),(43,9)|(41,10),(42,10)|(25,11),(26,11)|(41,11),(42,11)|(1,12),(2,12)|(17,12),(18,12)|(33,12),(34,12)|(2,13),(3,13)|(41,13),(42,13)|(3,14),(5,14)|(6,14),(9,14)|(46,14),(47,14)|(9,15),(15,15)|(21,15),(24,15)|(45,15),(46,15)|(5,16),(6,16)|(11,16),(12,16)|(15,16),(21,16)|(24,16),(45,16)|(12,20),(45,20)|(11,21),(15,21)|(45,21),(46,21)|(46,22),(47,22)|(45,30),(47,30)|(25,31),(29,31)|(41,31),(45,31)|(29,32),(41,32)|(34,33),(35,33)|(36,33),(37,33)|(38,33),(39,33)|(34,34),(35,34)|(36,34),(37,34)|(38,34),(39,34)|
(16,11),(17,12)|(18,9),(19,10)|(24,10),(25,11)|(26,8),(27,9)|(32,11),(33,12)|(34,9),(35,10)|(40,12),(41,13)|
(16,10),(17,9)|(18,12),(19,11)|(24,9),(25,8)|(26,11),(27,10)|(32,10),(33,9)|(34,12),(35,11)|(42,13),(43,12)|
(5.5,3),(5.5,8)|(5.5,9),(5.5,14)|
None|
end file : DS_A16