Pièce : DS_A26
taille : 48x35
################################################
#######################=########################
#######################.########################
#######################...................=#####
#################################....###########
##################################..############
###################################.############
###################################.############
###################################.############
###################################.####..######
###################################.####..######
###################################.####..######
###################################.####..######
###################################.####..######
###################################.####..######
###################################.####..######
###################################.####..######
###################################.####..######
###################################.####..######
###################################.####..######
####....#####......##############...####..######
##=................................#####..######
####..............................######..######
########################################..######
########################################..######
########################################..######
########################################..######
####......................................######
##=.......................................######
################################################
################################################
################################################
################################################
################################################
################################################
(2,21),(2,22)|(2,28),(2,29)|(4,20),(4,21)|(4,22),(4,23)|(4,27),(4,28)|(8,20),(8,21)|(13,20),(13,21)|(19,20),(19,21)|(23,1),(23,4)|(24,1),(24,3)|(33,4),(33,5)|(33,20),(33,21)|(34,5),(34,6)|(34,22),(34,23)|(35,6),(35,20)|(35,21),(35,22)|(36,5),(36,21)|(37,4),(37,5)|(40,9),(40,27)|(42,9),(42,29)|(43,3),(43,4)|
(23,1),(24,1)|(24,3),(43,3)|(23,4),(33,4)|(37,4),(43,4)|(33,5),(34,5)|(36,5),(37,5)|(34,6),(35,6)|(40,9),(42,9)|(4,20),(8,20)|(13,20),(19,20)|(33,20),(35,20)|(2,21),(4,21)|(8,21),(13,21)|(19,21),(33,21)|(35,21),(36,21)|(2,22),(4,22)|(34,22),(35,22)|(4,23),(34,23)|(4,27),(40,27)|(2,28),(4,28)|(2,29),(42,29)|




end file : DS_A26