Pièce : DS_C03
152x35
1117x-163
########################################################################################################################################################
########################################################################################################################################################
########################################################################################################################################################
########################################################################################################################################################
########################################################################################################################################################
########################################################################################################################################################
########################################################################################################################################################
########################################################################################################################################################
########################################################################################################################################################
#########.#.#####################.#.################################.#.###################################################################...=##########
#########.#.#####################.#.################################.#.###################################################################.#############
#########.#.#####################.#.################################.#.######################################....#########################.#############
#########.#.#####################.#.################################.#.###################################..........######################.#############
######/..............#...........................#........................#........................#........................#................./#########
######...............#...........................#.................................................#........................#..................#########
####=.......................................................................................................................#...................=#######
######.................................#.......................................................................................................#########
####=................#.......##......######.....................................................................................................=#######
######..............##....########.###########...#...###.........####.....#........##..............#.........#####..........#......###.........#########
########...........###..########################.#..########.....#####....####....#####...........###.....############......#..###########..../#########
#########.##############################################################################################################################################
#########.##############################################################################################################################################
####=.....##############################################################################################################################################
########################################################################################################################################################
########################################################################################################################################################
########################################################################################################################################################
########################################################################################################################################################
########################################################################################################################################################
########################################################################################################################################################
########################################################################################################################################################
########################################################################################################################################################
########################################################################################################################################################
########################################################################################################################################################
########################################################################################################################################################
########################################################################################################################################################
(4,15),(4,16)|(4,17),(4,18)|(4,22),(4,23)|(6,15),(6,16)|(6,17),(6,18)|(8,19),(8,20)|(9,9),(9,13)|(9,20),(9,22)|(10,9),(10,13)|(10,20),(10,23)|(11,9),(11,13)|(12,9),(12,13)|(19,19),(19,20)|(20,18),(20,19)|(21,13),(21,15)|(21,17),(21,18)|(22,13),(22,15)|(22,17),(22,20)|(24,19),(24,20)|(26,18),(26,19)|(29,17),(29,18)|(31,17),(31,18)|(33,9),(33,13)|(34,9),(34,13)|(34,18),(34,19)|(35,9),(35,13)|(35,18),(35,19)|(36,9),(36,13)|(37,17),(37,18)|(39,16),(39,17)|(40,16),(40,17)|(43,17),(43,18)|(46,18),(46,19)|(48,19),(48,20)|(49,13),(49,15)|(49,18),(49,20)|(50,13),(50,15)|(50,18),(50,20)|(52,19),(52,20)|(53,18),(53,19)|(56,18),(56,19)|(60,19),(60,20)|(65,18),(65,20)|(68,9),(68,13)|(69,9),(69,13)|(69,18),(69,19)|(70,9),(70,13)|(70,19),(70,20)|(71,9),(71,13)|(74,13),(74,14)|(74,18),(74,20)|(75,13),(75,14)|(75,18),(75,19)|(78,19),(78,20)|(82,19),(82,20)|(83,18),(83,19)|(85,18),(85,19)|(87,19),(87,20)|(98,19),(98,20)|(99,13),(99,15)|(99,18),(99,19)|(100,13),(100,15)|(100,18),(100,19)|(101,19),(101,20)|(106,12),(106,13)|(106,19),(106,20)|(109,11),(109,12)|(109,18),(109,19)|(113,11),(113,12)|(114,18),(114,19)|(116,12),(116,13)|(118,19),(118,20)|(124,13),(124,16)|(124,18),(124,20)|(125,13),(125,16)|(125,18),(125,20)|(127,19),(127,20)|(131,18),(131,19)|(134,18),(134,19)|(138,9),(138,13)|(138,19),(138,20)|(139,10),(139,13)|(142,9),(142,10)|(143,15),(143,16)|(143,17),(143,18)|(145,15),(145,16)|(145,17),(145,18)|
(9,9),(10,9)|(11,9),(12,9)|(33,9),(34,9)|(35,9),(36,9)|(68,9),(69,9)|(70,9),(71,9)|(138,9),(142,9)|(139,10),(142,10)|(109,11),(113,11)|(106,12),(109,12)|(113,12),(116,12)|(9,13),(10,13)|(11,13),(12,13)|(21,13),(22,13)|(33,13),(34,13)|(35,13),(36,13)|(49,13),(50,13)|(68,13),(69,13)|(70,13),(71,13)|(74,13),(75,13)|(99,13),(100,13)|(106,13),(116,13)|(124,13),(125,13)|(138,13),(139,13)|(74,14),(75,14)|(4,15),(6,15)|(21,15),(22,15)|(49,15),(50,15)|(99,15),(100,15)|(143,15),(145,15)|(4,16),(6,16)|(39,16),(40,16)|(124,16),(125,16)|(143,16),(145,16)|(4,17),(6,17)|(21,17),(22,17)|(29,17),(31,17)|(37,17),(39,17)|(40,17),(43,17)|(143,17),(145,17)|(4,18),(6,18)|(20,18),(21,18)|(26,18),(29,18)|(31,18),(34,18)|(35,18),(37,18)|(43,18),(46,18)|(49,18),(50,18)|(53,18),(56,18)|(65,18),(69,18)|(74,18),(75,18)|(83,18),(85,18)|(99,18),(100,18)|(109,18),(114,18)|(124,18),(125,18)|(131,18),(134,18)|(143,18),(145,18)|(6,19),(8,19)|(19,19),(20,19)|(24,19),(26,19)|(34,19),(35,19)|(46,19),(48,19)|(52,19),(53,19)|(56,19),(60,19)|(69,19),(70,19)|(75,19),(78,19)|(82,19),(83,19)|(85,19),(87,19)|(98,19),(99,19)|(100,19),(101,19)|(106,19),(109,19)|(114,19),(118,19)|(127,19),(131,19)|(134,19),(138,19)|(8,20),(9,20)|(10,20),(19,20)|(22,20),(24,20)|(48,20),(49,20)|(50,20),(52,20)|(60,20),(65,20)|(70,20),(74,20)|(78,20),(82,20)|(87,20),(98,20)|(101,20),(106,20)|(118,20),(124,20)|(125,20),(127,20)|(4,22),(9,22)|(4,23),(10,23)|
(142,13),(143,14)|
(6,14),(7,13)|(142,20),(143,19)|


end file : DS_C03