Pièce : HI_A11
taille : 48x35
################################################
################################################
#################............###################
################################################
################################################
################################################
################################################
#################............###################
#################............###################
#################............###################
#################............###################
##################..........####################
##################..........####################
#####.....................................######
###=.......................................=####
##################..........####################
##################..........####################
#################.....##.....###################
#################....####....###################
#################...######...###################
#################/##########/###################
################################################
#################/##########/###################
################################################
################################################
################################################
################################################
################################################
################################################
################################################
################################################
################################################
################################################
################################################
################################################
(3,14),(3,15)|(5,13),(5,14)|(17,2),(17,3)|(17,7),(17,11)|(18,11),(18,13)|(18,15),(18,17)|(20,19),(20,20)|(21,18),(21,19)|(22,17),(22,18)|(24,17),(24,18)|(25,18),(25,19)|(26,19),(26,20)|(28,11),(28,13)|(28,15),(28,17)|(29,2),(29,3)|(29,7),(29,11)|(42,13),(42,14)|(44,14),(44,15)|
(17,2),(29,2)|(17,3),(29,3)|(17,7),(29,7)|(17,11),(18,11)|(28,11),(29,11)|(5,13),(18,13)|(28,13),(42,13)|(3,14),(5,14)|(42,14),(44,14)|(3,15),(18,15)|(28,15),(44,15)|(17,17),(18,17)|(22,17),(24,17)|(28,17),(29,17)|(21,18),(22,18)|(24,18),(25,18)|(20,19),(21,19)|(25,19),(26,19)|(18,20),(20,20)|(26,20),(28,20)|




end file : HI_A11