Piece : SB_A09
48x35
-1200x982
################################################
################################################
################################################
################################################
################################################
################################################
################################################
################################################
################################################
################################################
################################################
################################################
##########.....#################################
########............############################
#######..............###########################
#####..................................#########
####.....................................#######
##..........................................####
#...................##########...............=##
#.............##################............####
#............###################################
##..........####################################
###........#####################################
###.......######################################
###......#######################################
###......#######################################
####....########################################
####....########################################
#####...########################################
#####...########################################
######.#########################################
######=#########################################
################################################
################################################
################################################
(1,18),(1,21)|(2,17),(2,18)|(2,21),(2,22)|(3,22),(3,26)|(4,16),(4,17)|(4,26),(4,28)|(5,15),(5,16)|(5,28),(5,30)|(6,30),(6,32)|(7,14),(7,15)|(7,30),(7,32)|(8,13),(8,14)|(8,26),(8,30)|(9,24),(9,26)|(10,12),(10,13)|(10,23),(10,24)|(11,22),(11,23)|(12,21),(12,22)|(13,20),(13,21)|(14,19),(14,20)|(15,12),(15,13)|(20,13),(20,14)|(20,18),(20,19)|(21,14),(21,15)|(30,18),(30,19)|(32,19),(32,20)|(39,15),(39,16)|(41,16),(41,17)|(44,17),(44,18)|(44,19),(44,20)|(46,18),(46,19)|
(10,12),(15,12)|(8,13),(10,13)|(15,13),(20,13)|(7,14),(8,14)|(20,14),(21,14)|(5,15),(7,15)|(21,15),(39,15)|(4,16),(5,16)|(39,16),(41,16)|(2,17),(4,17)|(41,17),(44,17)|(1,18),(2,18)|(20,18),(30,18)|(44,18),(46,18)|(14,19),(20,19)|(30,19),(32,19)|(44,19),(46,19)|(13,20),(14,20)|(32,20),(44,20)|(1,21),(2,21)|(12,21),(13,21)|(2,22),(3,22)|(11,22),(12,22)|(10,23),(11,23)|(9,24),(10,24)|(3,26),(4,26)|(8,26),(9,26)|(4,28),(5,28)|(5,30),(6,30)|(7,30),(8,30)|(6,32),(7,32)|
None|
None|
None|
None|
end file : SB_A09