Pièce : SS_A17
taille : 48x35
################################################
################################################
################################################
########################################.....=##
########################################.#######
########################################.#######
########################################.#######
#######################-#-------########.#######
#######################.........########.#######
########.........................#######.#######
##########----#--................#######.#######
########......................---+.......#######
########.........................###############
#########--#--...................###############
########.........................###############
########.........................###############
##=....+-----....................###############
########.........................###############
########......................---+.........#####
###########-------#---...........#########.#####
########...................###############.#####
########...................###############.#####
##########################################.#####
##########################################.#####
##########################################.#####
##########################################.#####
##########################################.#####
##########################################.#####
##########################################.#####
##########################################.#####
##########################################.#####
##########################################.#####
##########################################=#####
################################################
################################################
2,16|2,17|8,9|8,10|8,11|8,13|8,14|8,19|8,20|8,22|23,9|27,20|27,22|32,9|33,9|33,20|40,3|40,11|41,4|41,12|42,19|42,33|43,18|43,33|46,3|46,4|
(2,16),(2,17)|(8,9),(8,10)|(8,11),(8,13)|(8,14),(8,19)|(8,20),(8,22)|(23,9),(27,20)|(27,22),(32,9)|(33,9),(33,20)|(40,3),(40,11)|(41,4),(41,12)|(42,19),(42,33)|(43,18),(43,33)|(46,3),(46,4)|
(40,3),(46,3)|(41,4),(46,4)|(8,9),(23,9)|(32,9),(33,9)|(8,10),(8,11)|(40,11),(41,12)|(8,13),(8,14)|(2,16),(2,17)|(43,18),(8,19)|(42,19),(8,20)|(27,20),(33,20)|(8,22),(27,22)|(42,33),(43,33)|