Pièce : SS_A10
taille : 48x35
################################################
################################################
################################################
################################################
################################################
################################################
##############..../#########/.....##############
##############...../###=###/......##############
##############....../##|##/.......##############
##############.........|..........##############
##############.........|..........##############
##############.........|..........##############
##############.........|.........###############
##############.........|.........###############
###=...#######.........+---------+..........=###
######.#######.........|.........#######.#######
######.#######.........|.........#######.#######
######.#######.........|..........######.#######
######.#######.........|..........######.#######
######.#######.........|..........######.#######
######.#######....../##+##/.......######.#######
######.#######...../###.###/......######.#######
######.#######..../####.####/.....######.#######
######.################.################.#######
######.################.################.#######
######.################.################.#######
######.....=###########.############=....#######
#######################.################.#######
#######################.################.#######
##############...........................#######
##############.##.######################.#######
##############.##.######################.#######
##############=##...........=######=.....#######
################################################
################################################
3,14|3,15|6,15|6,27|7,14|7,26|12,26|12,27|14,6|14,23|14,29|14,33|15,30|15,33|17,30|17,33|18,30|18,32|23,7|23,29|24,7|24,29|29,32|29,33|33,12|33,17|34,6|34,12|34,17|34,23|35,32|35,33|36,26|36,27|40,15|40,26|40,27|40,29|40,30|40,32|41,15|41,33|45,14|45,15|
(3,14),(3,15)|(6,15),(6,27)|(7,14),(7,26)|(12,26),(12,27)|(14,6),(14,23)|(14,29),(14,33)|(15,30),(15,33)|(17,30),(17,33)|(18,30),(18,32)|(23,7),(23,29)|(24,7),(24,29)|(29,32),(29,33)|(33,12),(33,17)|(34,6),(34,12)|(34,17),(34,23)|(35,32),(35,33)|(36,26),(36,27)|(40,15),(40,26)|(40,27),(40,29)|(40,30),(40,32)|(41,15),(41,33)|(45,14),(45,15)|
(14,6),(34,6)|(23,7),(24,7)|(33,12),(34,12)|(3,14),(7,14)|(45,14),(3,15)|(6,15),(40,15)|(41,15),(45,15)|(33,17),(34,17)|(14,23),(34,23)|(7,26),(12,26)|(36,26),(40,26)|(6,27),(12,27)|(36,27),(40,27)|(14,29),(23,29)|(24,29),(40,29)|(15,30),(17,30)|(18,30),(40,30)|(18,32),(29,32)|(35,32),(40,32)|(14,33),(15,33)|(17,33),(29,33)|(35,33),(41,33)|