Pièce : SS_A16
taille : 48x35
################################################
################################################
##############.#################.###############
##############.#################.########=######
##############+#################+########.######
###########...|.................|....####.######
###########...|.................|....####.######
###########...|.................|....####.######
###########...|.../#########/...|....####.######
###########...|...###########...|....####.######
###########...|...###########...|....####.######
###########...|...###########...|....####+######
##...|........|.../#########/...|........|...###
##...|........|....#########....|........|...###
##...|........|....#########....|........|...###
##...|........|....#########....|........|...###
##...|........|....#########....|........|...###
##...|........|....#########....|........|...###
##...|........|....#########....|........|...###
##...|........|.../#########/...|........|...###
#####+########+#################+###############
#####.########.#################.###############
#####.########.#################.###############
#####.########.#################.###############
#####.########.#################.###############
#####.########.#################.###############
#####.########.#################.###############
#####.########..............................=###
#####.##############################.###########
#####.##############################.###########
#####=##############################.###########
################################################
################################################
################################################
################################################
2,12|2,20|5,31|6,31|11,5|11,12|14,2|14,28|15,2|15,27|32,2|32,27|33,2|33,27|36,28|36,31|37,5|37,12|37,28|37,31|41,3|42,3|45,12|45,20|45,27|45,28|
(2,12),(2,20)|(5,31),(6,31)|(11,5),(11,12)|(14,2),(14,28)|(15,2),(15,27)|(32,2),(32,27)|(33,2),(33,27)|(36,28),(36,31)|(37,5),(37,12)|(37,28),(37,31)|(41,3),(42,3)|(45,12),(45,20)|(45,27),(45,28)|
(14,2),(15,2)|(32,2),(33,2)|(41,3),(42,3)|(11,5),(37,5)|(2,12),(11,12)|(37,12),(45,12)|(2,20),(45,20)|(15,27),(32,27)|(33,27),(45,27)|(14,28),(36,28)|(37,28),(45,28)|(5,31),(6,31)|(36,31),(37,31)|