Pièce : SS_B05
taille : 104x35
########################################################################################################
#################################################################.######################################
#################################################################.##########=###########################
#########################.#######################################.##########.###########################
#########################.#######################################.##########.###########################
#########################.#######.###############################.##########.###########################
#########################.#######.###############################.##########.######.............=#######
#########################.#######.###############################.##########.######.####################
#########################....=###.###=.......................####.##########.######.####################
#########################.#######.##########################.####.##########.######.####################
#########################.#######.##########################.####.##########.######.####################
#########################.#######.##########################.####.##########.######.####################
####=.............#######...........................=#######.####.###=.......######.####################
#################.#######.#######.##########################.####.#################.####################
#################.#######.#######.##########################.####.#################.####################
#################.#######.#######.##########################.####.#################.####################
#################.#######.#######.##########################.####.......####.######.####################
#################.........#######.##########################.##########.####.######.####################
#################.#######.#######.##########################.##########.####.######.####################
#################.#######.#######.##########################.##########.####.######.####################
#################.#######.#######.##########################.##########.####.######.####################
#################.#######.#######.##########################.##########.####.######.####################
#################.#######.#######.##########################.##########.####.######.####################
#################.#######.#######.##########################................................############
#################.#######.#######################################.##########.###########################
#########################.#######################################.##########.###########################
#########################.#######################################.##########.###########################
#########################.#######################################.##########.###########################
#################################################################.##########.###########################
#################################################################.##########.###########################
#################################################################.##########.###########################
#################################################################.######################################
########################################################################################################
########################################################################################################
########################################################################################################
4,12|4,13|17,13|17,25|18,12|18,17|18,18|18,25|25,3|25,17|25,18|25,28|26,3|26,8|26,9|26,12|26,13|26,28|30,8|30,9|33,5|33,12|33,13|33,24|34,5|34,12|34,13|34,24|37,8|37,9|53,12|53,13|60,9|60,24|61,8|61,23|65,1|65,17|65,24|65,32|66,1|66,16|66,24|66,32|69,12|69,13|71,17|71,23|72,16|72,23|76,2|76,12|76,16|76,23|76,24|76,31|77,2|77,13|77,16|77,23|77,24|77,31|83,6|83,23|84,7|84,23|92,23|92,24|97,6|97,7|
(4,12),(4,13)|(17,13),(17,25)|(18,12),(18,17)|(18,18),(18,25)|(25,3),(25,17)|(25,18),(25,28)|(26,3),(26,8)|(26,9),(26,12)|(26,13),(26,28)|(30,8),(30,9)|(33,5),(33,12)|(33,13),(33,24)|(34,5),(34,12)|(34,13),(34,24)|(37,8),(37,9)|(53,12),(53,13)|(60,9),(60,24)|(61,8),(61,23)|(65,1),(65,17)|(65,24),(65,32)|(66,1),(66,16)|(66,24),(66,32)|(69,12),(69,13)|(71,17),(71,23)|(72,16),(72,23)|(76,2),(76,12)|(76,16),(76,23)|(76,24),(76,31)|(77,2),(77,13)|(77,16),(77,23)|(77,24),(77,31)|(83,6),(83,23)|(84,7),(84,23)|(92,23),(92,24)|(97,6),(97,7)|
(65,1),(66,1)|(76,2),(77,2)|(25,3),(26,3)|(33,5),(34,5)|(83,6),(97,6)|(84,7),(97,7)|(26,8),(30,8)|(37,8),(61,8)|(26,9),(30,9)|(37,9),(60,9)|(4,12),(18,12)|(26,12),(33,12)|(34,12),(53,12)|(69,12),(76,12)|(4,13),(17,13)|(26,13),(33,13)|(34,13),(53,13)|(69,13),(77,13)|(66,16),(72,16)|(76,16),(77,16)|(18,17),(25,17)|(65,17),(71,17)|(18,18),(25,18)|(61,23),(71,23)|(72,23),(76,23)|(77,23),(83,23)|(84,23),(92,23)|(33,24),(34,24)|(60,24),(65,24)|(66,24),(76,24)|(77,24),(92,24)|(17,25),(18,25)|(25,28),(26,28)|(76,31),(77,31)|(65,32),(66,32)|