Pièce : SS_B02
taille : 48x78
################################################
################################################
################################################
###=.....................#######################
########################.#######################
########################...............#########
########################.#############.#########
########################.#############.......=##
########################.#############.#########
#############..........................#########
########################.#######################
########################.#######################
########################.#######################
########################.#######################
########################.#######################
########################.#######################
#########.#..#..########.#######..#..#.#########
#########....#..########+#######..#....#########
#########....#..#####...|..#####..#....#########
#########....#..#####...|..#####..#....#########
#########....#..#####---+--#####..|....#########
#########....|..#####...|..#####..|....#########
#########....|..#####...|..#####..#....#########
#########....|..#####---+--#####..|....#########
#########.......#####...|..#####..|....#########
#########.......#####...|../###/..|....#########
#########.......#####...|...###...|....#########
#########......./###/...|...###........#########
#########........###....|...###........#########
#########........###....|...###........#########
#########........###....|...###........#########
#########........###....|...###........#########
#########........###........###........#########
#########........###........###........#########
#########........###........###........#########
#########........###........###........#########
#########........###........###........#########
#########........###........###........#########
#########........###......./###/.......#########
#########........###.......#####.......#########
#########........###.......#####.......#########
#########........###.......#####.......#########
#########......./###/......#####.......#########
#########.......#####......#####.......#########
#########.......#####......#####.......#########
#########.......#####......#####.......#########
#########.......#####......#####.......#########
#########.......#####......#####.......#########
#########.......#####....../###/.......#########
#########.......#####.......###........#########
#########.......#####.......###........#########
#########.......#####.......###........#########
#########.......#####.......###........#########
#########......./###/.......###........#########
#########........###........###........#########
#########........###........###...|....#########
#########....|...###........###...|....#########
#########....|...###...|....###...#....#########
#########....|...###...|....###...|....#########
#########....|...###...|....###...|....#########
#########....#...###...|....###...|....#########
#########....#...###...|.../###/..|....#########
#########....|...###...|...#####..#....#########
#########....|...###...|...#####..#....#########
#########.|..|...###...|...#####..#.|..#########
#########.|..#...###...|...#####..#.|..#########
#########.|..#../###/..|...#####..#.|..#########
#########.|..#..#####..|...#####..#.#..#########
#########.#..#..#######+########..#.#..#########
#########.#..#..#######.########..#.#..#########
#########.#..#..#######.########..#.#..#########
#######################.########################
#######################=########################
################################################
################################################
################################################
################################################
################################################
(3,3),(3,4)|(9,16),(9,71)|(10,16),(10,17)|(10,68),(10,71)|(11,16),(11,17)|(11,68),(11,71)|(13,9),(13,10)|(13,16),(13,21)|(13,60),(13,62)|(13,65),(13,71)|(14,16),(14,21)|(14,60),(14,62)|(14,65),(14,71)|(16,16),(16,71)|(21,18),(21,68)|(23,68),(23,73)|(24,4),(24,9)|(24,10),(24,18)|(24,68),(24,73)|(25,3),(25,5)|(25,6),(25,9)|(25,10),(25,18)|(27,18),(27,68)|(32,16),(32,71)|(34,16),(34,20)|(34,22),(34,23)|(34,57),(34,58)|(34,62),(34,71)|(35,16),(35,20)|(35,22),(35,23)|(35,57),(35,58)|(35,62),(35,71)|(36,67),(36,71)|(37,16),(37,17)|(37,67),(37,71)|(38,6),(38,9)|(38,16),(38,17)|(39,5),(39,7)|(39,8),(39,10)|(39,16),(39,71)|(46,7),(46,8)|
(3,3),(25,3)|(3,4),(24,4)|(25,5),(39,5)|(25,6),(38,6)|(39,7),(46,7)|(39,8),(46,8)|(13,9),(24,9)|(25,9),(38,9)|(13,10),(24,10)|(25,10),(39,10)|(9,16),(10,16)|(11,16),(13,16)|(14,16),(16,16)|(32,16),(34,16)|(35,16),(37,16)|(38,16),(39,16)|(10,17),(11,17)|(37,17),(38,17)|(21,18),(24,18)|(25,18),(27,18)|(34,20),(35,20)|(13,21),(14,21)|(34,22),(35,22)|(34,23),(35,23)|(34,57),(35,57)|(34,58),(35,58)|(13,60),(14,60)|(13,62),(14,62)|(34,62),(35,62)|(13,65),(14,65)|(36,67),(37,67)|(10,68),(11,68)|(21,68),(23,68)|(24,68),(27,68)|(9,71),(10,71)|(11,71),(13,71)|(14,71),(16,71)|(32,71),(34,71)|(35,71),(36,71)|(37,71),(39,71)|(23,73),(24,73)|
(16,27),(17,28)|(16,53),(17,54)|(20,42),(21,43)|(20,66),(21,67)|(27,25),(28,26)|(27,48),(28,49)|(31,38),(32,39)|(31,61),(32,62)|
(16,43),(17,42)|(16,67),(17,66)|(20,28),(21,27)|(20,54),(21,53)|(27,39),(28,38)|(27,62),(28,61)|(31,26),(32,25)|(31,49),(32,48)|
(10.5,64),(10.5,68)|(13.5,21),(13.5,24)|(13.5,56),(13.5,60)|(13.5,62),(13.5,65)|(23.5,57),(24.5,32)|(34.5,20),(34.5,22)|(34.5,23),(34.5,27)|(34.5,55),(34.5,57)|(34.5,58),(34.5,62)|(36.5,64),(36.5,67)|
(21,20.5),(21,23.5)|(27,20.5),(27,23.5)|
