Pièce : SS_B02
taille : 48x78
################################################
################################################
################################################
###=.....................#######################
########################.#######################
########################...............#########
########################.#############.#########
########################.#############.......=##
########################.#############.#########
#############..........................#########
########################.#######################
########################.#######################
########################.#######################
########################.#######################
########################.#######################
########################.#######################
#########.#..#..########.#######..#..#.#########
#########....#..########+#######..#....#########
#########....#..#####...|..#####..#....#########
#########....#..#####...|..#####..#....#########
#########....#..#####---+--#####..|....#########
#########....|..#####...|..#####..|....#########
#########....|..#####...|..#####..#....#########
#########....|..#####---+--#####..|....#########
#########.......#####...|..#####..|....#########
#########.......#####...|../###/..|....#########
#########.......#####...|...###...|....#########
#########......./###/...|...###........#########
#########........###....|...###........#########
#########........###....|...###........#########
#########........###....|...###........#########
#########........###....|...###........#########
#########........###........###........#########
#########........###........###........#########
#########........###........###........#########
#########........###........###........#########
#########........###........###........#########
#########........###........###........#########
#########........###......./###/.......#########
#########........###.......#####.......#########
#########........###.......#####.......#########
#########........###.......#####.......#########
#########......./###/......#####.......#########
#########.......#####......#####.......#########
#########.......#####......#####.......#########
#########.......#####......#####.......#########
#########.......#####......#####.......#########
#########.......#####......#####.......#########
#########.......#####....../###/.......#########
#########.......#####.......###........#########
#########.......#####.......###........#########
#########.......#####.......###........#########
#########.......#####.......###........#########
#########......./###/.......###........#########
#########........###........###........#########
#########........###........###...|....#########
#########....|...###........###...|....#########
#########....|...###...|....###...#....#########
#########....|...###...|....###...|....#########
#########....|...###...|....###...|....#########
#########....#...###...|....###...|....#########
#########....#...###...|.../###/..|....#########
#########....|...###...|...#####..#....#########
#########....|...###...|...#####..#....#########
#########.|..|...###...|...#####..#.|..#########
#########.|..#...###...|...#####..#.|..#########
#########.|..#../###/..|...#####..#.|..#########
#########.|..#..#####..|...#####..#.#..#########
#########.#..#..#######+########..#.#..#########
#########.#..#..#######.########..#.#..#########
#########.#..#..#######.########..#.#..#########
#######################.########################
#######################=########################
################################################
################################################
################################################
################################################
################################################
(3,3),(3,4)|(9,16),(9,71)|(10,16),(10,17)|(10,71),(11,16)|(11,17),(11,71)|(13,9),(13,10)|(13,16),(13,71)|(14,16),(14,71)|(16,16),(16,71)|(21,18),(21,68)|(23,73),(24,4)|(24,9),(24,10)|(24,73),(25,3)|(25,5),(25,6)|(25,9),(25,10)|(27,18),(27,68)|(32,16),(32,71)|(34,16),(34,71)|(35,16),(35,71)|(36,71),(37,16)|(37,17),(37,71)|(38,6),(38,9)|(38,16),(38,17)|(39,5),(39,7)|(39,8),(39,10)|(39,16),(39,71)|(46,7),(46,8)|
(3,3),(25,3)|(3,4),(24,4)|(25,5),(39,5)|(25,6),(38,6)|(39,7),(46,7)|(39,8),(46,8)|(13,9),(24,9)|(25,9),(38,9)|(13,10),(24,10)|(25,10),(39,10)|(9,16),(10,16)|(11,16),(13,16)|(14,16),(16,16)|(32,16),(34,16)|(35,16),(37,16)|(38,16),(39,16)|(10,17),(11,17)|(37,17),(38,17)|(21,18),(27,18)|(21,68),(27,68)|(9,71),(10,71)|(11,71),(13,71)|(14,71),(16,71)|(32,71),(34,71)|(35,71),(36,71)|(37,71),(39,71)|(23,73),(24,73)|