Pièce : SS_B03
taille : 48x78
################################################
################################################
################################################
######################=###=#####################
######################.###.#####################
######################.###.#####################
######################.###.#####################
####################.#..#....###################
####################.#..|...####################
####################....|...####################
####################....|....###################
####################....|....###################
####################....|....###################
####################....|....###################
####################....|....###################
####################....|....###################
####################....|....###################
####################....|....###################
####################....|....###################
####################....|....###################
####################....|....###################
####################....|....###################
####################....|....###################
####################....|....###################
####################....|....###################
####################..#####..###################
####################--#####--###################
####################..#####..###################
####################..#####..###################
####################--#####--###################
####################..#####..###################
####################....|....###################
####################....|....###################
####################....|....###################
####################....|....###################
####################....|....###################
####################....|....###################
####################....|....###################
####################....|....###################
####################....|....###################
####################....|....###################
####################....|....###################
####################....|....###################
####################....|....###################
####################....|....###################
####################....|....###################
####################....|....###################
####################....|....###################
####################....|....###################
####################....|....###################
####################....|....###################
####################....|....###################
####################..#####..###################
####################--#####--###################
####################..#####..###################
####################--#####--###################
####################..#####..###################
####################....|....###################
####################....|....###################
####################....|....###################
####################....|....###################
####################....|....###################
####################....|....###################
####################....|...####################
####################....|...####################
#####################...#...####################
#####################...#...####################
######################.###.#####################
######################.###.#####################
######################.###.#####################
######################=###=#####################
################################################
################################################
################################################
################################################
################################################
################################################
################################################
21,7|23,7|25,7|24,7|26,7|27,7|29,7|22,9|21,9|28,8|29,8|28,10|29,10|22,25|27,25|22,31|27,31|22,52|27,52|22,57|27,57|28,63|29,63|20,65|21,65|21,67|22,67|23,67|25,67|24,67|26,67|27,67|28,67|