Pièce : SS_C02
taille : 48x121
################################################
################################################
################################################
################################################
################################################
################################################
################################################
################################################
################################################
#.|.............|.........................######
#.|.............|.........................######
#.|.............|.........................##.###
#.###...........|.........#############...##.###
#.###...........|.........#############...##.###
#.###...........|...................###...##.###
#.|..........#######......#########.###...##.###
#.|..........#######......#########.###...##.###
#.|..........#######......#########.###...##+###
#.|........--#######--.........####.###.....|.##
#.|..........#######......####.####.###.....|.##
#.|..........#######......####.####.###.....|.##
#.|..........#######......####.####.###.....|.##
#.###...........|.........####.####.###.....|.##
#.###...........|...........................|.##
#.###...........|.........#########.###.....|.##
#.|.............|.........#########.###.....|.##
#.|.............|...........................|.##
#.|.............|...........................|.##
#.|.............|...........................|.##
#.|.............|...........................|.##
#.|.............|...........................|.##
##+#########.#####........#########.############
##.#########.#####........#########.############
##..................................############
#####.######.#####........#############.......##
#####.######.#####........#############.......##
#.|.............|.........#############.......##
#.|.............|...................############
#.|.............|.........#########.############
#.|............###........#########.############
#.|............###........#########..........=##
#.|............###........#########.############
####............|.........#########.############
####............|...................############
####............|.........######################
#.|.............|.........######################
#.|.............|........./#####################
#.|.............|........../###########.......##
#.|............##...........###########.......##
#.|............##...........#/#########.......##
#.|.............|...........#.##################
#.|.............|...........#.##################
#.|.............|...........#.##################
#.|.............|...........|.###/##############
#.|.............|...........|.###./#############
#####.############..........|.###../############
#####.############..........|.###.../###########
##..........................|.###..../##########
##.#########.#####..........|.###...../#########
##+#########.#####..........|..|.......#########
#.|.............|...........|..|.......#########
#.|.............|..............##......#########
#.|............................##......###/#####
#.|.........|..................|.......###./####
#.|.........|..................|.......###../###
#.|.........|..................|.......###.../##
#.|.........|..................#.......###..../#
#.|.........#..................|........|......#
#.|.........#..................|........|......#
#/|.........|..................|........#......#
##/.........|......|...........|........#......#
###/........|......|...........|........|......#
####/......###.....|...........|........|......#
#####/.....###.....|...........|........|......#
######/....####....#...........|........|......#
#######/...###.....#...........|........|......#
########/..###.....|...........|........|......#
#########/.###.....|....................|......#
##########/###.....|....................|......#
##############....###...................|......#
###############...###..........................#
###############...###..........................#
###############...###..........................#
###############/..###..........................#
################/.###..........................#
#################/####......|..................#
#####################.......|...........|......#
#####################.......|...........|......#
######################......|...........|......#
######################......|...........|......#
######################......|...........|......#
########..........####......|.....|.....|......#
########..........##=.......|.....|.....|......#
########..........####......|.....|.....|......#
########..........####......|.....|.....|......#
####################=.......|.....|.....#......#
######################......|.....|.....#......#
######################......#.....|.....|......#
######################......|.....|.....|......#
########....................|.....|.....|......#
########....................|.....|.....|......#
##=.........................|.....|....###.....#
########....................|.....#....###.....#
########....................|.....#....###.....#
######################......|.....#....###.....#
######################......|.....|....###.....#
######################.....###....|....###.....#
####################=......###....|....###.....#
########..........####.....###....|....###.....#
########..........####.....###...###...###.....#
########..........##=......###...###...###.....#
######################.....###...###...###.....#
######################.....###...###...###.....#
########..........####.....###...###..#####....#
########..........####....#####..###..#####....#
########..........####----#####-#####-#####----#
########..........####....#####.#####.#####....#
################################################
################################################
################################################
################################################
42,9|44,11|45,11|5,12|26,12|39,12|26,14|36,14|5,15|13,15|20,15|26,15|35,15|26,18|31,18|42,18|46,18|26,19|30,19|13,22|20,22|5,22|26,23|30,23|31,23|35,23|36,23|39,23|5,25|26,24|35,24|36,24|39,24|26,26|35,26|36,26|39,26|1,31|12,31|13,31|18,31|26,31|35,31|36,31|46,31|3,33|12,33|13,33|18,33|26,33|35,33|39,34|46,34|2,34|5,34|6,34|12,34|13,34|18,34|26,34|36,34|1,36|5,36|6,36|12,36|13,36|18,36|26,37|36,37|39,37|46,37|26,38|35,38|15,39|18,39|36,40|15,42|18,42|36,41|1,42|4,42|26,43|35,43|1,45|4,45|26,44|36,44|26,46|39,47|46,47|28,48|15,48|15,50|30,50|29,49|39,50|46,50|33,53|1,55|5,55|6,55|18,55|2,57|5,57|6,57|18,57|3,58|12,58|13,58|18,58|30,59|33,59|39,59|1,60|12,60|13,60|18,60|33,61|33,63|42,62|39,67|42,67|47,67|1,69|11,72|14,72|14,75|14,74|15,75|15,74|11,78|10,79|18,79|21,79|14,80|15,80|15,83|18,85|17,86|21,86|21,85|22,86|22,85|21,88|22,88|8,91|18,91|22,92|22,93|22,95|8,95|18,95|22,96|8,99|22,99|8,101|39,101|42,101|8,102|8,104|22,104|22,107|27,106|30,106|8,108|18,108|22,108|22,110|33,109|36,109|8,111|18,111|22,111|8,113|18,113|38,113|39,113|42,113|43,113|26,114|27,114|30,114|31,114|33,115|36,115|8,117|18,117|22,117|26,117|31,117|32,117|37,117|38,117|43,117|47,117|