Pièce : SS_D02
taille : 104x78
########################################################################################################
########################################################################################################
###########################################################################=###=########################
###=....###################################################################.###.########################
#######.###################################################################.###.########################
#######.#####...............######.......................................##.###.##...........###########
#######.#####---------------######--##-----..............................##.###.##...........###########
#######+#####...............######............................................................|..|.#####
##.|...|......................................................................................|..|.#####
##.|...|......................................................................................|..|.#####
##.|...|......................................................................................|..|.#####
##.|...|......................................................................................|..|.#####
##.|...|......................................................................................|..|.#####
##.|...|......................................................................................|..|.#####
##.|...|......................................................................................|..|.#####
##.|...|......................................................................................|..|.#####
##.|...|......................................................................................|..|.#####
##.#####......................................................................................|..|.#####
##.#####......................................................................................|..|.#####
##.#####......................................................................................|..|.#####
##.#####......................................................................................|..|.#####
##.#####......................................................................................|..|.#####
##.#####......................................................................................|..|.#####
##.#####......................................................................................|..|.#####
##.#####......................................................................................|..|.#####
##.#####......................................................................................|..|..####
##.|...|......................................................................................|..|..####
##.|...|......................................................................................|..|...=##
##.|...|......................................................................................|..|..####
##.|...|.................................../#############/....................................|..|...=##
##.|...|................................../###############/...................................|..|..####
##.|...|................................./#################/..................................|..|...=##
##.|...|.................................###################..................................|..|..####
##.|...|.................................###################..................................|..|.#####
##.|...|.................................###################.................................###########
##.|...|.................................###################.................................###########
##.|...|.................................###################.................................###########
##.|...|.................................###################.................................###########
##.|...|.................................###################.................................###########
########.................................###################..................................|..|.#####
########.................................###################..................................|..|.#####
########.................................###################..................................|..|.#####
########.................................###################..................................|..|.#####
##.|...|................................./##################..................................|..|.#####
##.|...|................................../#################..................................|..|.#####
##.|...|.................................../################..................................|..|.#####
##.|...|..............................................|...|...................................|..|.#####
##.|...|..............................................|...|...................................|..|.#####
##.|...|..............................................|...|...................................|..|.#####
##.|...|..............................................|...|...................................|..|.#####
##.|...|..............................................|...|...................................####.#####
##.|...|..............................................|...|...................................####.#####
##.|...|..............................................|...|...................................####.#####
##.|...|..............................................|...|...................................####.#####
##.|...|..............................................|...|...................................####.#####
##.|...|..............................................|...|...................................####.#####
##.|...|..............................................#####...................................####.#####
##.|...|..............................................#####...................................####.#####
##.#####..............................................#####...................................####.#####
##.#####..............................................#####...................................|..|.#####
##.#####..............................................#####...................................|..|.#####
##.#####..............................................#####...................................|..|.#####
##.#####..............................................#####...................................|..|.#####
##.#####..............................................#####...................................|..|.#####
##.#####..............................................#####...................................|..|.#####
##.#####..............................................|...|...................................|..|.#####
##.#####..............................................|...|...................................|..|.#####
##.|...|..............................................|...|...................................|..|.#####
##.|...|..............................................|...|...................................|..|.#####
##.|...|............................####..............|...|..............................##..####+######
##.|...|............................####..............|...|.............-----------#-----##--####.######
##.|...|............................####..............|...|..................................####.######
##############......................####...######################################################.######
##############......................####...######################################################=######
########################################################################################################
########################################################################################################
########################################################################################################
########################################################################################################
2,8|2,39|2,43|2,72|3,3|3,4|7,4|8,3|13,5|13,8|14,72|14,74|28,5|28,8|34,5|34,8|36,69|36,74|40,69|40,74|43,72|43,74|60,46|73,5|73,7|75,2|75,7|76,2|76,7|79,2|79,7|80,2|80,7|82,5|82,7|89,69|91,69|93,5|93,7|93,34|93,39|93,69|93,72|97,74|98,74|99,7|99,25|99,33|99,34|99,39|99,69|100,25|100,27|100,28|100,29|100,30|100,31|100,32|100,33|102,27|102,28|102,29|102,30|102,31|102,32|
(2,8),(2,39)|(2,43),(2,72)|(3,3),(3,4)|(7,4),(8,3)|(13,5),(13,8)|(14,72),(14,74)|(28,5),(28,8)|(34,5),(34,8)|(36,69),(36,74)|(40,69),(40,74)|(43,72),(43,74)|(60,46),(73,5)|(73,7),(75,2)|(75,7),(76,2)|(76,7),(79,2)|(79,7),(80,2)|(80,7),(82,5)|(82,7),(89,69)|(91,69),(93,5)|(93,7),(93,34)|(93,39),(93,69)|(93,72),(97,74)|(98,74),(99,7)|(99,25),(99,33)|(99,34),(99,39)|(99,69),(100,25)|(100,27),(100,28)|(100,29),(100,30)|(100,31),(100,32)|(100,33),(102,27)|(102,28),(102,29)|(102,30),(102,31)|
(75,2),(76,2)|(79,2),(80,2)|(3,3),(8,3)|(3,4),(7,4)|(13,5),(28,5)|(34,5),(73,5)|(82,5),(93,5)|(73,7),(75,7)|(76,7),(79,7)|(80,7),(82,7)|(93,7),(99,7)|(2,8),(13,8)|(28,8),(34,8)|(99,25),(100,25)|(100,27),(102,27)|(100,28),(102,28)|(100,29),(102,29)|(100,30),(102,30)|(100,31),(102,31)|(100,32),(102,32)|(99,33),(100,33)|(93,34),(99,34)|(2,39),(93,39)|(99,39),(2,43)|(60,46),(36,69)|(40,69),(89,69)|(91,69),(93,69)|(99,69),(2,72)|(14,72),(43,72)|(93,72),(14,74)|(36,74),(40,74)|(43,74),(97,74)|