Pièce : SS_D07
taille : 204x35
############################################################################################################################################################################################################
############################################################################################################################################################################################################
###############=######################/###############/##################/###############/##################/###############/##################/###############/####################/###############/#######
#############|#|#######################/#############/####################/#############/####################/#############/####################/#############/######################/#############/########
###########/.|.|./##########################################################################################################################################################################################
##########...|.#...#########################################################################################################################################################################################
##########...|.#...#########################################################################################################################################################################################
##########...|.#...####################/#############/####################/#############/####################/#############/####################/#############/######################/#############/########
##########...|.....###################/###############/##################/###############/##################/###############/##################/###############/####################/###############/#######
##########...|.....#########################################################################################################################################################################################
##########...|.....#########################################################################################################################################################################################
##########...|.....#########################################################################################################################################################################################
##########...|.....#########################################################################################################################################################################################
##########...#.....#######################/#######/##########################/#######/##########################/#######/##########################/#######/############################/#######/###########
##########...#.....######################/#########/########################/#########/########################/#########/########################/#########/##########################/#########/##########
##########...|.....##########/##########/###########/##########//##########/###########/##########//##########/###########/##########//##########/###########/##########/##/##########/###########/#########
##########...|.....####################/#############/####################/#############/####################/#############/####################/#############/######################/#############/########
##########...|.....#########################################################################################################################################################################################
##########...|.....#########################################################################################################################################################################################
##########.........#########################################################################################################################################################################################
##########.........#########################################################################################################################################################################################
##########.........#########################################################################################################################################################################################
##########...|.....#########################################################################################################################################################################################
##########...|.....#########################################################################################################################################################################=###############
##########...|.......-----#----------------------#----------------------#----------------------#----------------------#----------------------#----------------------#-------#............./#|#/.#.....######
##########...#.|............................................................................................................................................................................|.........######
##########...#.|............................................................................................................................................................................|.........######
###########..#.|............................................................................................................................................................................|.........######
##########...#.#.....-----#----------------------#----------------------#----------------------#----------------------#----------------------#----------------------#-------#............./#H#/.#...########
##########../###/..#########################################################################################################################################################################################
##########.#######.#########################################################################################################################################################################################
############################################################################################################################################################################################################
############################################################################################################################################################################################################
############################################################################################################################################################################################################
############################################################################################################################################################################################################
(10,5),(10,27)|(10,28),(10,31)|(11,27),(11,28)|(11,30),(11,31)|(13,3),(13,4)|(13,13),(13,15)|(14,3),(14,4)|(14,13),(14,15)|(14,25),(14,29)|(15,2),(15,4)|(15,5),(15,8)|(15,28),(15,29)|(16,2),(16,4)|(16,5),(16,8)|(18,30),(18,31)|(19,5),(19,24)|(19,29),(19,31)|(26,24),(26,25)|(26,28),(26,29)|(27,24),(27,25)|(27,28),(27,29)|(49,24),(49,25)|(49,28),(49,29)|(50,24),(50,25)|(50,28),(50,29)|(72,24),(72,25)|(72,28),(72,29)|(73,24),(73,25)|(73,28),(73,29)|(95,24),(95,25)|(95,28),(95,29)|(96,24),(96,25)|(96,28),(96,29)|(118,24),(118,25)|(118,28),(118,29)|(119,24),(119,25)|(119,28),(119,29)|(141,24),(141,25)|(141,28),(141,29)|(142,24),(142,25)|(142,28),(142,29)|(164,24),(164,25)|(164,28),(164,29)|(165,24),(165,25)|(165,28),(165,29)|(172,24),(172,25)|(172,28),(172,29)|(173,24),(173,25)|(173,28),(173,29)|(188,23),(188,25)|(188,28),(188,29)|(189,23),(189,25)|(189,28),(189,29)|(192,24),(192,25)|(192,28),(192,29)|(193,24),(193,25)|(193,28),(193,29)|(196,28),(196,29)|(198,24),(198,28)|
(15,15),(16,2)|(13,13),(14,3)|(13,13),(14,4)|(15,15),(16,4)|(10,10),(15,5)|(16,16),(19,5)|(15,15),(16,8)|(13,13),(14,13)|(13,13),(14,15)|(188,188),(189,23)|(19,19),(26,24)|(27,27),(49,24)|(50,50),(72,24)|(73,73),(95,24)|(96,96),(118,24)|(119,119),(141,24)|(142,142),(164,24)|(165,165),(172,24)|(173,173),(192,24)|(193,193),(198,24)|(13,13),(14,25)|(26,26),(27,25)|(49,49),(50,25)|(72,72),(73,25)|(95,95),(96,25)|(118,118),(119,25)|(141,141),(142,25)|(164,164),(165,25)|(172,172),(173,25)|(188,188),(189,25)|(192,192),(193,25)|(10,10),(11,27)|(10,10),(11,28)|(15,15),(16,28)|(26,26),(27,28)|(49,49),(50,28)|(72,72),(73,28)|(95,95),(96,28)|(118,118),(119,28)|(141,141),(142,28)|(164,164),(165,28)|(172,172),(173,28)|(188,188),(189,28)|(192,192),(193,28)|(196,196),(198,28)|(14,14),(15,29)|(19,19),(26,29)|(27,27),(49,29)|(50,50),(72,29)|(73,73),(95,29)|(96,96),(118,29)|(119,119),(141,29)|(142,142),(164,29)|(165,165),(172,29)|(173,173),(188,29)|(189,189),(192,29)|(193,193),(196,29)|(11,11),(18,30)|(10,10),(11,31)|(18,18),(19,31)|
(16,29),(17,30)|(17,4),(18,5)|(186,24),(187,25)|(186,24),(190,28)|(186,24),(191,29)|
(11,5),(12,4)|(12,30),(13,29)|(186,29),(187,28)|(186,29),(190,25)|(186,29),(191,24)|
(13.5,3),(13.5,13)|(13.5,15),(13.5,19)|(13.5,22),(13.5,25)|(15.5,3),(15.5,5)|(15.5,25),(15.5,28)|(188.5,24),(188.5,28)|
(21,24.5),(21,28.5)|(26,24.5),(26,28.5)|(27,24.5),(27,28.5)|(49,24.5),(49,28.5)|(50,24.5),(50,28.5)|(72,24.5),(72,28.5)|(73,24.5),(73,28.5)|(95,24.5),(95,28.5)|(96,24.5),(96,28.5)|(118,24.5),(118,28.5)|(119,24.5),(119,28.5)|(141,24.5),(141,28.5)|(142,24.5),(142,28.5)|(164,24.5),(164,28.5)|(165,24.5),(165,28.5)|(172,24.5),(172,28.5)|
end file : SS_D07