Piece : SS_E04
255x35
330x-812
###############################################################################################################################################################################################################################################################
###############################################################################################################################################################################################################################################################
###############################################################################################################################################################################################################################################################
###############################################################################################################################################################################################################################################################
###############################################################################################################################################################################################################################################################
###############################################################################################################################################################################################################################################################
##################################################################################################################################################################################################################################....#########################
#############################################################################################################################################################################################################################...............###################
#########################################################################################################################################################################################################################..............................########
############################################################################################################################.....########################################################################################--......................------########
########.#..#..#..#./#######################################################################################################.###.########################################################################################..............................########
########.|..|..|..|../######################################################################################################.###.########################################################################################..............................########
########.|..|..|..|.../#####################################################################################################.###.########################################################################################..............................########
#######..|..|..|..|.......................................................#.............................................####.###.####.........................#............................|..........................................................#########
#######..|..|..|..|.......................................................|.............................................####.###.####.........................|............................|..........................................................#########
#####=...|..|..|..|.......................................................|........................................-----+....###....+-----....................|............................|...........................................-----------#---+....=###
#######..|..|..|..|.......................................................|.............................................#############.........................|............................|..........................................................#########
#######..|..|..|..|.......................................................|.............................................#############.........................|............................|..........................................................#########
#####=...|..|..|..|.......................................................|.............................................#############.........................|............................|.....................................................-----+....=###
#######..|..|..|..|.......................................................|..........................................---+....###....+---......................|............................|..........................................................#########
#######..|..|..|..|.......................................................#.............................................####.###.####.........................|............................#..........................................................#########
########.|..|..|..|.../#####################################################################################################.###.########################################################################################/.............................########
########.|..|..|..|../######################################################################################################.###.#########################################################################################/............................########
########.#..#..#..#./#######################################################################################################.###.##########################################################################################/..........................#########
############################################################################################################################.###.###########################################################################################/-.................------##########
############################################################################################################################.###.############################################################################################/...................##############
############################################################################################################################.###.##############################################################################################............####################
############################################################################################################################.###.##############################################################################################################################
############################################################################################################################.....##############################################################################################################################
###############################################################################################################################################################################################################################################################
###############################################################################################################################################################################################################################################################
###############################################################################################################################################################################################################################################################
###############################################################################################################################################################################################################################################################
###############################################################################################################################################################################################################################################################
###############################################################################################################################################################################################################################################################
(5,15),(5,16)|(5,18),(5,19)|(7,13),(7,15)|(7,16),(7,18)|(7,19),(7,21)|(8,10),(8,13)|(8,21),(8,24)|(9,10),(9,11)|(9,23),(9,24)|(10,10),(10,11)|(10,23),(10,24)|(12,10),(12,11)|(12,23),(12,24)|(13,10),(13,11)|(13,23),(13,24)|(15,10),(15,11)|(15,23),(15,24)|(16,10),(16,11)|(16,23),(16,24)|(18,10),(18,11)|(18,23),(18,24)|(19,10),(19,11)|(19,23),(19,24)|(74,13),(74,14)|(74,20),(74,21)|(75,13),(75,14)|(75,20),(75,21)|(120,13),(120,15)|(120,16),(120,19)|(120,20),(120,21)|(124,9),(124,15)|(124,20),(124,29)|(125,10),(125,16)|(125,19),(125,28)|(128,10),(128,16)|(128,19),(128,28)|(129,9),(129,15)|(129,20),(129,29)|(133,13),(133,15)|(133,16),(133,19)|(133,20),(133,21)|(158,13),(158,14)|(159,13),(159,14)|(187,20),(187,21)|(188,20),(188,21)|(217,8),(217,13)|(221,7),(221,8)|(223,26),(223,27)|(226,6),(226,7)|(230,6),(230,7)|(235,26),(235,27)|(236,7),(236,8)|(241,25),(241,26)|(242,15),(242,16)|(243,15),(243,16)|(245,24),(245,25)|(246,13),(246,15)|(246,16),(246,18)|(246,19),(246,21)|(246,23),(246,24)|(247,8),(247,13)|(247,21),(247,23)|(252,15),(252,16)|(252,18),(252,19)|
(226,6),(230,6)|(221,7),(226,7)|(230,7),(236,7)|(217,8),(221,8)|(236,8),(247,8)|(124,9),(129,9)|(8,10),(9,10)|(10,10),(12,10)|(13,10),(15,10)|(16,10),(18,10)|(19,10),(20,10)|(125,10),(128,10)|(9,11),(10,11)|(12,11),(13,11)|(15,11),(16,11)|(18,11),(19,11)|(7,13),(8,13)|(23,13),(74,13)|(75,13),(120,13)|(133,13),(158,13)|(159,13),(217,13)|(246,13),(247,13)|(74,14),(75,14)|(158,14),(159,14)|(5,15),(7,15)|(120,15),(124,15)|(129,15),(133,15)|(242,15),(243,15)|(246,15),(252,15)|(5,16),(7,16)|(120,16),(125,16)|(128,16),(133,16)|(242,16),(243,16)|(246,16),(252,16)|(5,18),(7,18)|(246,18),(252,18)|(5,19),(7,19)|(120,19),(125,19)|(128,19),(133,19)|(246,19),(252,19)|(74,20),(75,20)|(120,20),(124,20)|(129,20),(133,20)|(187,20),(188,20)|(7,21),(8,21)|(23,21),(74,21)|(75,21),(120,21)|(133,21),(187,21)|(188,21),(217,21)|(246,21),(247,21)|(9,23),(10,23)|(12,23),(13,23)|(15,23),(16,23)|(18,23),(19,23)|(246,23),(247,23)|(8,24),(9,24)|(10,24),(12,24)|(13,24),(15,24)|(16,24),(18,24)|(19,24),(20,24)|(245,24),(246,24)|(241,25),(245,25)|(222,26),(223,26)|(235,26),(241,26)|(223,27),(235,27)|(125,28),(128,28)|(124,29),(129,29)|
(20,10),(23,13)|(217,21),(222,26)|
(20,24),(23,21)|
(9.5,11),(9.5,23)|(12.5,11),(12.5,23)|(15.5,11),(15.5,23)|(18.5,11),(18.5,23)|(74.5,14),(74.5,20)|(120.5,15),(120.5,16)|(120.5,19),(120.5,20)|(132.5,15),(132.5,16)|(132.5,19),(132.5,20)|(158.5,14),(158.5,21)|(187.5,13),(187.5,20)|(246.5,15),(246.5,16)|(246.5,18),(246.5,19)|
(217,9.5),(219,9.5)|(241,9.5),(247,9.5)|(115,15.5),(121,15.5)|(132,15.5),(138,15.5)|(231,15.5),(242,15.5)|(243,15.5),(247,15.5)|(241,18.5),(247,18.5)|(117,19.5),(121,19.5)|(132,19.5),(136,19.5)|(221,24.5),(222,24.5)|(239,24.5),(245,24.5)|
end file : SS_E04