Pièce : SS_E08
taille : 48x189
################################################
################################################
################################################
#########=##=####.......###.........##...#######
#########.##.####.......###.........##...#######
#########+##+####.......###.........##...#######
#######..|..|...........#...........##...#######
#######..|..|...........#................#######
######/..|..|...........#................/######
#####/...|..|............................./#####
#####....|..|..............................#####
#####....|.................................#####
#####....|.................................#####
#####....|.................................#####
#####....|.................................#####
#####....|.................................#####
#####....|.................................#####
#####....|.................................#####
#####....|.................................#####
#####....|.................................#####
#####....|.................................#####
#####....|.................................#####
#####....|.................................#####
#####....|.................................#####
#####....|.................................#####
#####....|.................................#####
#####......................................#####
#####......................................#####
#####/..................................../#####
######/................................../######
#######..................................#######
#######.................................########
################################################
#########.##.###################################
#########.##.####........................#######
#########+##+####........................#######
#######..|..|............................#######
#######..|..|............................#######
#######..|..|............................#######
#######..|..|............................#######
#######..|..|............................#######
#######..|...............................#######
#######..|...............................#######
#######..|...............................#######
######/..|.............................../######
#####/...|................................/#####
#####....|.................................#####
#####......................................#####
#####......................................#####
#####......................................#####
#####.......|..............................#####
#####.......|..............................#####
#####.......|..............................#####
#####.......|..............................#####
#####.......|..............................#####
#####.......|..............................#####
#####.......|..............................#####
#####.......|..............................#####
#####.......|..............................#####
#####....|..|..............................#####
#####....|..|..............................#####
#####....|..|..............................#####
#####....|..|..............................#####
#####....|..|..............................#####
#####/...|..|............................./#####
######/..|..|............................/######
#######..|..|............................#######
#######..|..|............................#######
################################################
###################################.##.#########
#######..#..#..................####.##.#########
#######........................####+##+#########
#######............................|..|..#######
#######............................|..|..#######
#######...............................|..#######
#######...............................|..#######
#######...............................|..#######
#######...............................|..#######
#######...............................|..#######
#######...............................|..#######
#######...............................|..#######
######/...............................|../######
#####/................................|.../#####
#####.................................|....#####
#####.................................|....#####
#####.................................|....#####
#####.................................|....#####
#####.................................|....#####
#####.................................|....#####
#####.................................|....#####
#####.................................|....#####
#####.................................|....#####
#####.................................|....#####
#####.................................|....#####
#####.................................|....#####
#####.................................|....#####
#####.................................|....#####
#####.................................|....#####
#####.................................|....#####
#####.................................|....#####
#####.................................|....#####
#####..............................|..|....#####
#####/.............................|..|.../#####
######/............................|..|../######
#######............................|..|..#######
#######............................|..|..#######
################################################
#########.##.###################################
#########.##.####..................#..#..#######
#########+##+####........................#######
#######..|..|............................#######
#######..|..|............................#######
#######..|..|............................#######
#######..|..|............................#######
#######..|..|............................#######
#######..|..|............................#######
#######..|..|............................#######
#######..|..|............................#######
#######..|...............................#######
#######..|...............................#######
######/..|.............................../######
#####/...|................................/#####
#####....|.................................#####
#####....|.................................#####
#####....|.................................#####
#####....|.................................#####
#####....|.................................#####
#####....|.................................#####
#####....|.................................#####
#####....|..|..............................#####
#####....|..|..............................#####
#####....|..|..............................#####
#####....|..|..............................#####
#####....|..|..............................#####
#####....|..|..............................#####
#####....|..|..............................#####
#####....|..|..............................#####
#####....|..|..............................#####
#####....|..|..............................#####
#####....|..|..............................#####
#####/...|..|............................./#####
######/..|..|............................/######
#######..|..|............................#######
#######..|..|............................#######
################################################
###################################.##.#########
#######..#..#..................####.##.#########
#######........................####+##+#########
#######............................|..|..#######
#######............................|..|..#######
#######............................|..|..#######
#######............................|..|..#######
#######............................|..|..#######
#######............................|..|..#######
#######............................|..|..#######
#######............................|..|..#######
#######............................|..|..#######
#######............................|..|..#######
#######............................|..|..#######
#######............................|..|..#######
#######............................|..|..#######
#######............................|..|..#######
#######............................|..|..#######
#######............................|..|..#######
#######............................|..|..#######
#######............................|..|..#######
#######............................|..|..#######
#######........................####|##|#########
#######........................####|##|#########
#######........................####|##|#########
#######............................|..|..#######
#######............................|..|..#######
#######............................|..|..#######
#######............................|..|..#######
#######............................|..|..#######
#######............................|..|.########
#######........................#################
#########/...../################################
################################################
###########=#=##################################
################################################
################################################
################################################
################################################
################################################
################################################
################################################
################################################
################################################
(7,6),(7,32)|(7,36),(7,68)|(7,70),(7,106)|(7,110),(7,144)|(7,146),(7,177)|(9,3),(9,33)|(9,70),(9,71)|(9,107),(9,146)|(9,147),(10,3)|(10,33),(10,70)|(10,71),(10,107)|(10,146),(10,147)|(11,179),(11,180)|(12,3),(12,33)|(12,70),(12,71)|(12,107),(12,146)|(12,147),(12,179)|(12,180),(13,3)|(13,33),(13,70)|(13,71),(13,107)|(13,146),(13,147)|(13,179),(13,180)|(14,179),(14,180)|(17,3),(17,6)|(17,34),(17,36)|(17,108),(17,110)|(24,3),(24,9)|(25,6),(25,9)|(27,3),(27,6)|(31,70),(31,72)|(31,146),(31,148)|(31,167),(31,170)|(31,176),(31,177)|(35,69),(35,108)|(35,109),(35,145)|(36,3),(36,7)|(36,69),(36,108)|(36,109),(36,145)|(38,3),(38,7)|(38,69),(38,108)|(38,109),(38,145)|(39,69),(39,108)|(39,109),(39,145)|(40,31),(40,32)|(40,175),(40,176)|(41,3),(41,31)|(41,34),(41,68)|(41,72),(41,106)|(41,108),(41,144)|(41,148),(41,167)|(41,170),(41,175)|
(9,3),(10,3)|(12,3),(13,3)|(17,3),(24,3)|(27,3),(36,3)|(38,3),(41,3)|(7,6),(17,6)|(25,6),(27,6)|(36,7),(38,7)|(24,9),(25,9)|(40,31),(41,31)|(7,32),(40,32)|(9,33),(10,33)|(12,33),(13,33)|(17,34),(41,34)|(7,36),(17,36)|(7,68),(41,68)|(35,69),(36,69)|(38,69),(39,69)|(7,70),(9,70)|(10,70),(12,70)|(13,70),(31,70)|(9,71),(10,71)|(12,71),(13,71)|(31,72),(41,72)|(7,106),(41,106)|(9,107),(10,107)|(12,107),(13,107)|(17,108),(35,108)|(36,108),(38,108)|(39,108),(41,108)|(35,109),(36,109)|(38,109),(39,109)|(7,110),(17,110)|(7,144),(41,144)|(35,145),(36,145)|(38,145),(39,145)|(7,146),(9,146)|(10,146),(12,146)|(13,146),(31,146)|(9,147),(10,147)|(12,147),(13,147)|(31,148),(41,148)|(31,167),(41,167)|(31,170),(41,170)|(40,175),(41,175)|(31,176),(40,176)|(7,177),(31,177)|(11,179),(12,179)|(13,179),(14,179)|(11,180),(12,180)|(13,180),(14,180)|
(5,28),(7,30)|(5,64),(7,66)|(5,102),(7,104)|(5,140),(7,142)|(9,177),(10,178)|(41,8),(43,10)|(41,44),(43,46)|(41,81),(43,83)|(41,120),(43,122)|
(5,10),(7,8)|(5,46),(7,44)|(5,83),(7,81)|(5,122),(7,120)|(15,178),(16,177)|(41,30),(43,28)|(41,66),(43,64)|(41,104),(43,102)|(41,142),(43,140)|
