Pièce : SS_LAB8
taille : 48x35
################################################
################################################
######################....................######
######################--##-----#----------+..=##
##########................................######
##########................................######
##########................................######
####.|..|.................................|.|.##
####.|..|.................................|.|.##
####.|..|.................................|.|.##
####.####.................................|.|.##
####.####.................................|.|.##
####.####.................................|.|.##
####.####.................................|.|.##
####.####.................................###.##
####.####.................................###.##
####.####.................................###.##
####.|..|.................................###.##
####.|..|.................................###.##
####.|..|.................................###.##
####.|..|.................................###.##
####.|..|.................................|.|.##
####.|..|.................................|.|.##
####.|..|.................................|.|.##
####.|..|.................................|.|.##
####.|..|.................................|.|.##
##########................................|.|.##
##########................................|.|.##
####=....+--.............................#######
##########............|..|...............#######
##########............|..|..|............#######
####=....+--......####|##|##|#####.......#######
##########........####=##=########.......#######
################################################
################################################
(4,7),(4,26)|(4,28),(4,29)|(4,31),(4,32)|(10,4),(10,7)|(10,26),(10,33)|(18,31),(18,33)|(22,2),(22,33)|(23,33),(25,33)|(26,33),(34,31)|(34,33),(41,28)|(41,33),(42,2)|(46,3),(46,4)|(46,7),(46,28)|
(22,2),(42,2)|(46,3),(10,4)|(46,4),(4,7)|(10,7),(46,7)|(4,26),(10,26)|(4,28),(41,28)|(46,28),(4,29)|(4,31),(18,31)|(34,31),(4,32)|(10,33),(18,33)|(22,33),(23,33)|(25,33),(26,33)|(34,33),(41,33)|