Pièce : SS_LAB9
taille : 48x35
################################################
################################################
###########........############...........######
#########=---------########=#=###----#-...######
###########........########|#|#...........######
####.|..|..................|.|............######
####.|..|..................|.|............######
####.|..|......................................#
####.|..|......................................#
####.|..|......................................#
####.|..|......................................#
####.|..|......................................#
####.|..|......................................#
####.|..|......................................#
####.|..|.................................######
####.|..|.................................######
####.|..|.................................######
####.|..|.................................######
####.|..|.................................######
####.####.................................######
####.####......................................#
####.####......................................#
####.####......................................#
####.####......................................#
####.####......................................#
####.####......................................#
####.####......................................#
####.|..|......................................#
####.|..|......................................#
##########................................######
##########................................######
########=----------#-..................----=####
##########................................######
################################################
################################################
(4,5),(4,29)|(5,19),(5,27)|(8,31),(8,32)|(9,3),(9,4)|(9,19),(9,27)|(10,29),(10,31)|(10,32),(10,33)|(11,2),(11,3)|(11,4),(11,5)|(19,2),(19,5)|(19,31),(19,32)|(20,31),(20,32)|(27,3),(27,5)|(28,3),(28,5)|(29,3),(29,5)|(30,3),(30,5)|(31,2),(31,3)|(31,4),(31,5)|(33,3),(33,4)|(37,3),(37,4)|(38,3),(38,4)|(42,2),(42,7)|(42,14),(42,20)|(42,29),(42,31)|(42,32),(42,33)|(44,31),(44,32)|(47,7),(47,14)|(47,20),(47,29)|
(11,2),(19,2)|(31,2),(42,2)|(9,3),(11,3)|(27,3),(28,3)|(29,3),(30,3)|(31,3),(33,3)|(37,3),(38,3)|(9,4),(11,4)|(31,4),(33,4)|(37,4),(38,4)|(4,5),(11,5)|(19,5),(27,5)|(28,5),(29,5)|(30,5),(31,5)|(42,7),(47,7)|(42,14),(47,14)|(5,19),(9,19)|(42,20),(47,20)|(5,27),(9,27)|(4,29),(10,29)|(42,29),(47,29)|(8,31),(10,31)|(19,31),(20,31)|(42,31),(44,31)|(8,32),(10,32)|(19,32),(20,32)|(42,32),(44,32)|(10,33),(42,33)|


(5.5,5),(5.5,19)|(5.5,27),(5.5,29)|(8.5,5),(8.5,19)|(8.5,27),(8.5,29)|(27.5,4),(27.5,7)|(29.5,4),(29.5,7)|
(9,31.5),(10,3.5)|(19,3.5),(19,31.5)|(20,31.5),(21,31.5)|(33,3.5),(37,3.5)|(38,3.5),(39,3.5)|(39,31.5),(43,31.5)|
