Piece : LF_A04
48x35
910x278
################################################
################################################
################################################
################################################
#####=###################=################=#####
#####.###################.################.#####
#####.##################...###############.#####
#####.##################...###############+#####
#####.##################...##############.|.####
#####.##################...##############.|.####
#####.###################.###############.|.####
#####.###################.###############.|.####
#####.###################.###############.|.####
#####.#############............##########.|.####
#####.#############.#####.####.##########.|.####
#####.#############.#####.####.###########H#####
#####.#############.#####.####.####...####.#####
#####...............#####+####.###.....###.#####
########################.|.###.###.....###.#####
########################.|.###.............#####
########################.|.#####################
#######################/.|./####################
#######################..|..####################
#######################..|..####################
###############...#####..|..####################
##############.....####..|..####################
##############.....####..|..####################
##############.....####..|..####################
#######################/.|./####################
########=..###.###.#####.|.#####################
##########.###.###.#####.|.#####################
##########.....###.######H######################
##################.######.######################
##################........######################
################################################
(5,4),(5,18)|(6,4),(6,17)|(8,29),(8,30)|(10,30),(10,32)|(11,29),(11,31)|(14,25),(14,28)|(14,29),(14,31)|(15,24),(15,25)|(15,29),(15,32)|(18,24),(18,25)|(18,29),(18,34)|(19,13),(19,17)|(19,25),(19,28)|(19,29),(19,33)|(20,14),(20,18)|(23,22),(23,28)|(24,6),(24,10)|(24,18),(24,21)|(24,29),(24,31)|(25,4),(25,6)|(25,10),(25,13)|(25,14),(25,18)|(25,31),(25,33)|(26,4),(26,6)|(26,10),(26,13)|(26,14),(26,18)|(26,31),(26,34)|(27,6),(27,10)|(27,18),(27,21)|(27,29),(27,31)|(28,22),(28,28)|(30,14),(30,20)|(31,13),(31,19)|(34,17),(34,19)|(35,16),(35,17)|(38,16),(38,17)|(39,17),(39,19)|(41,8),(41,15)|(42,4),(42,8)|(42,15),(42,19)|(43,4),(43,8)|(43,15),(43,20)|(44,8),(44,15)|
(5,4),(6,4)|(25,4),(26,4)|(42,4),(43,4)|(24,6),(25,6)|(26,6),(27,6)|(41,8),(42,8)|(43,8),(44,8)|(24,10),(25,10)|(26,10),(27,10)|(19,13),(25,13)|(26,13),(31,13)|(20,14),(25,14)|(26,14),(30,14)|(41,15),(42,15)|(43,15),(44,15)|(35,16),(38,16)|(6,17),(19,17)|(34,17),(35,17)|(38,17),(39,17)|(5,18),(20,18)|(24,18),(25,18)|(26,18),(27,18)|(31,19),(34,19)|(39,19),(42,19)|(30,20),(43,20)|(15,24),(18,24)|(14,25),(15,25)|(18,25),(19,25)|(14,28),(19,28)|(8,29),(11,29)|(14,29),(15,29)|(18,29),(19,29)|(8,30),(10,30)|(11,31),(14,31)|(24,31),(25,31)|(26,31),(27,31)|(10,32),(15,32)|(19,33),(25,33)|(18,34),(26,34)|
(23,28),(24,29)|(27,21),(28,22)|
(23,22),(24,21)|(27,29),(28,28)|
(25.5,17),(25.5,31)|(42.5,7),(42.5,15)|
(42,7.5),(43,7.5)|(25,17.5),(26,17.5)|
end file : LF_A04