Pièce : LF_A17
taille : 54x35
######################################################
######################################################
######################################################
######################################################
######################################################
######################################################
######################################################
######################################################
######################################################
######################################################
######################################################
######################################################
##############.########################.##############
############.....####################.....############
#########.............#.........#..............#######
##########....................................########
#########......................................#######
#########.......................................=#####
#########......................................#######
#########.......................................=#####
##########.....................................#######
#########.....####..............................=#####
#########.....####.............####............#######
########/.....####............#####.............=#####
#######......#####.............####.........##########
#####=........####............#####...#H#H############
#######.......####.............####...#|.|############
#####=........####.............####....+-+.###########
#######.......####.............####....|.|.###########
########/..............................|.|.###########
###########............................|.#############
######################################################
######################################################
######################################################
######################################################
(5,25),(5,26)|(5,27),(5,28)|(7,24),(7,25)|(7,26),(7,27)|(7,28),(7,29)|(9,14),(9,15)|(9,16),(9,20)|(9,21),(10,15)|(10,16),(10,20)|(10,21),(11,30)|(11,31),(12,13)|(12,14),(13,24)|(13,25),(14,12)|(14,13),(14,21)|(14,24),(14,25)|(14,29),(15,12)|(15,13),(17,13)|(17,14),(18,21)|(18,29),(22,14)|(22,15),(23,14)|(23,15),(30,23)|(30,24),(30,25)|(30,26),(31,22)|(31,23),(31,24)|(31,25),(31,26)|(31,29),(32,14)|(32,15),(33,14)|(33,15),(35,22)|(35,29),(37,13)|(37,14),(38,25)|(38,27),(39,12)|(39,13),(39,25)|(39,27),(40,12)|(40,13),(40,25)|(40,26),(41,25)|(41,26),(41,30)|(41,31),(42,13)|(42,14),(42,25)|(42,27),(43,27)|(43,30),(44,24)|(44,25),(46,15)|(46,16),(47,14)|(47,15),(47,16)|(47,17),(47,18)|(47,19),(47,20)|(47,21),(47,22)|(47,23),(49,17)|(49,18),(49,19)|(49,20),(49,21)|(49,22),(49,23)|
(14,12),(15,12)|(39,12),(40,12)|(12,13),(14,13)|(15,13),(17,13)|(37,13),(39,13)|(40,13),(42,13)|(9,14),(12,14)|(17,14),(22,14)|(23,14),(32,14)|(33,14),(37,14)|(42,14),(47,14)|(9,15),(10,15)|(22,15),(23,15)|(32,15),(33,15)|(46,15),(47,15)|(9,16),(10,16)|(46,16),(47,16)|(47,17),(49,17)|(47,18),(49,18)|(47,19),(49,19)|(9,20),(10,20)|(47,20),(49,20)|(9,21),(10,21)|(14,21),(18,21)|(47,21),(49,21)|(31,22),(35,22)|(47,22),(49,22)|(30,23),(31,23)|(47,23),(49,23)|(7,24),(13,24)|(14,24),(30,24)|(31,24),(44,24)|(49,24),(5,25)|(7,25),(13,25)|(14,25),(30,25)|(31,25),(38,25)|(39,25),(40,25)|(41,25),(42,25)|(44,25),(5,26)|(7,26),(30,26)|(31,26),(40,26)|(41,26),(5,27)|(7,27),(38,27)|(39,27),(42,27)|(43,27),(5,28)|(7,28),(7,29)|(14,29),(18,29)|(31,29),(35,29)|(11,30),(41,30)|(43,30),(11,31)|
(8,29),(9,30)|
(8,24),(9,23)|
(39.5,26),(39.5,31)|(41.5,26),(41.5,30)|

