Pièce : LF_A15
48x35
-648x298
################################################
################################################
################################################
################################################
################################################
################################################
################################################
##############################=#################
##############################.#################
##############################.#################
##############################.#################
##############################.#################
#######.......................................##
#######.##########.###########.##########.######
#######.##########.###########.##########.######
#######+##########.###########.##########+######
######.|.#########.............#########.|.#####
######.|.#########.###########.#########.|.#####
######.|.#########.###########+#########.|.#####
######.|.#########.##########.|.########...#####
######.|.########...#########.|.########...#####
######.|.########...#########.|.########...#####
######.|.#######....#########.|.########.|.#####
######.|.######......########.|.########.|.#####
######.|.######......########.|.########.|.#####
######.|.######..|###########.|.########.|.#####
#######+########......########+##########+######
#######=#########....#########.##########=######
##################.###########=#################
##################.#############################
##################=#############################
################################################
################################################
################################################
################################################
(6,16),(6,26)|(7,12),(7,16)|(7,26),(7,28)|(8,13),(8,16)|(8,26),(8,28)|(9,16),(9,26)|(15,23),(15,26)|(16,22),(16,23)|(16,26),(16,27)|(17,20),(17,22)|(17,27),(17,28)|(18,13),(18,20)|(18,25),(18,26)|(18,28),(18,31)|(19,13),(19,16)|(19,17),(19,20)|(19,28),(19,31)|(20,20),(20,23)|(21,23),(21,25)|(21,27),(21,28)|(22,26),(22,27)|(29,19),(29,26)|(30,7),(30,12)|(30,13),(30,16)|(30,17),(30,19)|(30,26),(30,29)|(31,7),(31,12)|(31,13),(31,19)|(31,26),(31,29)|(32,19),(32,26)|(40,16),(40,26)|(41,13),(41,16)|(41,26),(41,28)|(42,13),(42,16)|(42,26),(42,28)|(43,16),(43,26)|(46,12),(46,13)|
(30,7),(31,7)|(7,12),(30,12)|(31,12),(46,12)|(8,13),(18,13)|(19,13),(30,13)|(31,13),(41,13)|(42,13),(46,13)|(6,16),(7,16)|(8,16),(9,16)|(19,16),(30,16)|(40,16),(41,16)|(42,16),(43,16)|(19,17),(30,17)|(29,19),(30,19)|(31,19),(32,19)|(17,20),(18,20)|(19,20),(20,20)|(16,22),(17,22)|(15,23),(16,23)|(20,23),(21,23)|(18,25),(21,25)|(6,26),(7,26)|(8,26),(9,26)|(15,26),(16,26)|(18,26),(22,26)|(29,26),(30,26)|(31,26),(32,26)|(40,26),(41,26)|(42,26),(43,26)|(16,27),(17,27)|(21,27),(22,27)|(7,28),(8,28)|(17,28),(18,28)|(19,28),(21,28)|(41,28),(42,28)|(30,29),(31,29)|(18,31),(19,31)|


(7.5,15),(7.5,27)|(17.5,25),(17.5,26)|(30.5,18),(30.5,27)|(41.5,15),(41.5,19)|(41.5,22),(41.5,27)|
(7,15.5),(8,15.5)|(41,15.5),(42,15.5)|(30,18.5),(31,18.5)|(7,26.5),(8,26.5)|(30,26.5),(31,26.5)|(41,26.5),(42,26.5)|
end file : LF_A15