Pièce : HI_A27
taille : 48x35
################################################
################################################
################################################
################################################
################################################
################################################
################################################
#######.................................########
################################################
################################################
################################################
################################################
###########...........................##########
#######.................................########
######...................................#######
######...................................#######
######...................................#######
######...................................#######
####=...................................########
######..................................########
####=.................................##########
######................................##########
####=....##.............................########
######.#####.......................##.##########
##############/...../###########################
################################################
################=#=#############################
################################################
################################################
################################################
################################################
################################################
################################################
################################################
################################################