Pièce : HI_A27
taille : 48x35
################################################
################################################
################################################
################################################
################################################
################################################
################################################
#######.................................########
################################################
################################################
################################################
################################################
###########...........................##########
#######.................................########
######...................................#######
######...................................#######
######...................................#######
######...................................#######
####=...................................########
######..................................########
####=.................................##########
######................................##########
####=....##.............................########
######.#####.......................##.##########
##############/...../###########################
################################################
################=#=#############################
################################################
################################################
################################################
################################################
################################################
################################################
################################################
################################################
(4,18),(4,19)|(4,20),(4,21)|(4,22),(4,23)|(6,14),(6,18)|(6,19),(6,20)|(6,21),(6,22)|(6,23),(6,24)|(7,7),(7,8)|(7,13),(7,14)|(7,23),(7,24)|(9,22),(9,23)|(11,12),(11,13)|(11,22),(11,23)|(12,23),(12,24)|(16,26),(16,27)|(17,26),(17,27)|(18,26),(18,27)|(19,26),(19,27)|(35,23),(35,24)|(37,23),(37,24)|(38,12),(38,13)|(38,20),(38,22)|(38,23),(38,24)|(40,7),(40,8)|(40,13),(40,14)|(40,18),(40,20)|(40,22),(40,23)|(41,14),(41,18)|
(7,7),(40,7)|(7,8),(40,8)|(11,12),(38,12)|(7,13),(11,13)|(38,13),(40,13)|(6,14),(7,14)|(40,14),(41,14)|(4,18),(6,18)|(40,18),(41,18)|(4,19),(6,19)|(4,20),(6,20)|(38,20),(40,20)|(4,21),(6,21)|(4,22),(6,22)|(9,22),(11,22)|(38,22),(40,22)|(4,23),(6,23)|(7,23),(9,23)|(11,23),(12,23)|(35,23),(37,23)|(38,23),(40,23)|(6,24),(7,24)|(12,24),(35,24)|(37,24),(38,24)|(16,26),(17,26)|(18,26),(19,26)|(16,27),(17,27)|(18,27),(19,27)|