Pièce : HI_A07
taille : 54x35
######################################################
######################################################
######################################################
###################=##################################
###################|##################################
##################.|.#################################
##################.|.#################################
##################.|.#################################
##################.|.#################################
##################.|.#################################
##################.|.#################################
##################.|.#################################
##################.|.#################################
##################.|.#################################
##################.|.#################################
##################.|.#################################
##################.|.#################################
##################.|.#################################
##################.|.#################################
##################.|.#################################
##################.|.#################################
##################.|.#################################
##################.|.#################################
##################.|.#################################
##################.|.#################################
##################.|.#################################
##################.|..################################
#####..............|.............................#####
#####..............|.............................#####
###=...............|..............................=###
#####..............|.............................#####
###=...............|..............................=###
#####.............###............................#####
######################################################
######################################################
3,29|3,30|3,31|3,32|5,27|5,29|5,30|5,31|5,32|5,33|18,5|18,27|18,32|18,33|19,3|20,3|21,5|21,26|21,32|21,33|22,26|22,27|49,27|49,29|49,30|49,31|49,32|49,33|51,29|51,30|51,31|51,32|
(3,29),(3,30)|(3,31),(3,32)|(5,27),(5,29)|(5,30),(5,31)|(5,32),(5,33)|(18,5),(18,27)|(18,32),(18,33)|(19,3),(20,3)|(21,5),(21,26)|(21,32),(21,33)|(22,26),(22,27)|(49,27),(49,29)|(49,30),(49,31)|(49,32),(49,33)|(51,29),(51,30)|(51,31),(51,32)|
(19,3),(20,3)|(18,5),(21,5)|(21,26),(22,26)|(5,27),(18,27)|(22,27),(49,27)|(3,29),(5,29)|(49,29),(51,29)|(3,30),(5,30)|(49,30),(51,30)|(3,31),(5,31)|(49,31),(51,31)|(3,32),(5,32)|(18,32),(21,32)|(49,32),(51,32)|(5,33),(18,33)|(21,33),(49,33)|