Pièce : HI_A24
taille : 54x35
######################################################
######################...#............################
#######..................##############........#######
#####=..........................................=#####
#######...........###..........................#######
#####=............###...........................=#####
#######..........#####..................###....#######
######################################################
#######################=#=############################
######################################################
######################################################
######################################################
######################################################
######################################################
######################################################
######################################################
######################################################
######################################################
######################################################
######################################################
######################################################
######################################################
######################################################
######################################################
######################################################
######################################################
######################################################
######################################################
######################################################
######################################################
######################################################
######################################################
######################################################
######################################################
######################################################
(5,3),(5,4)|(5,5),(5,6)|(7,2),(7,3)|(7,4),(7,5)|(7,6),(7,7)|(17,6),(17,7)|(18,4),(18,6)|(21,4),(21,6)|(22,1),(22,2)|(22,6),(22,7)|(23,8),(23,9)|(24,8),(24,9)|(25,1),(25,3)|(25,8),(25,9)|(26,1),(26,2)|(26,8),(26,9)|(38,1),(38,2)|(39,2),(39,3)|(40,6),(40,7)|(43,6),(43,7)|(47,2),(47,3)|(47,4),(47,5)|(47,6),(47,7)|(49,3),(49,4)|(49,5),(49,6)|
(22,22),(25,1)|(26,26),(38,1)|(7,7),(22,2)|(26,26),(38,2)|(39,39),(47,2)|(5,5),(7,3)|(25,25),(39,3)|(47,47),(49,3)|(5,5),(7,4)|(18,18),(21,4)|(47,47),(49,4)|(5,5),(7,5)|(47,47),(49,5)|(5,5),(7,6)|(17,17),(18,6)|(21,21),(22,6)|(40,40),(43,6)|(47,47),(49,6)|(7,7),(17,7)|(22,22),(40,7)|(43,43),(47,7)|(23,23),(24,8)|(25,25),(26,8)|(23,23),(24,9)|(25,25),(26,9)|




end file : HI_A24