Pièce : HI_B07
taille : 106x35
######....................................................................................................
#######...................................................................................................
##############............................................................................................
##############............................................................................................
######....................................................................................................
####=.....................................................................................................
##############............................................................................................
##############............................................................................................
######....................................................................................................
######........##..........................................................................................
######...########.........................................................................................
######---########.........................................................................................
######....................................................................................................
######....................................................................................................
######---########.........................................................................................
######...########.........................................................................................
####=....................................................................................|................
######...............................|...................................................|................
###################..................|...................................................||...............
###################..................|....................................##########.####HH####...........
###################....|......|......|.....|.............................................||...............
###################....|......|......|.....|.......................#.....................||...............
###################.../#/..../#/..../#/.../#/...................####.....................||...............
###################...###....###....###...###...#####...........####......###############H#####...........
######................###....###....###...#############.........####......#####################...........
######.############..####...####...####..################.....######..../#######################..........
######.#############################################################################################......
######.####################################################=##########=##############################.....
######.##############################################################################################.....
######.##############################################################################################.....
######.############.....................................#############################################.....
####=....................................................=###########################################.....
#####################################################################################################.....
#####################################################################################################.....
#####################################################################################################.....
(4,5),(4,6)|(4,16),(4,17)|(4,31),(4,32)|(6,0),(6,1)|(6,4),(6,5)|(6,8),(6,16)|(6,17),(6,18)|(6,24),(6,31)|(7,1),(7,2)|(7,25),(7,31)|(9,10),(9,12)|(9,14),(9,16)|(14,2),(14,4)|(14,6),(14,8)|(14,9),(14,10)|(16,9),(16,10)|(17,10),(17,12)|(17,14),(17,16)|(19,18),(19,24)|(19,25),(19,26)|(19,30),(19,31)|(21,25),(21,26)|(22,23),(22,25)|(25,23),(25,26)|(28,25),(28,26)|(29,23),(29,25)|(32,23),(32,26)|(35,25),(35,26)|(36,23),(36,25)|(39,23),(39,26)|(41,25),(41,26)|(42,23),(42,25)|(45,23),(45,24)|(48,23),(48,24)|(53,23),(53,24)|(55,24),(55,25)|(56,30),(56,31)|(57,25),(57,26)|(58,31),(58,32)|(59,27),(59,28)|(60,27),(60,28)|(62,25),(62,26)|(64,22),(64,25)|(67,21),(67,22)|(68,21),(68,26)|(70,27),(70,28)|(71,27),(71,28)|(74,19),(74,20)|(74,23),(74,25)|(84,19),(84,20)|(85,19),(85,20)|(89,19),(89,20)|(89,23),(89,24)|(90,23),(90,24)|(91,19),(91,20)|(95,19),(95,20)|(95,23),(95,25)|(96,25),(96,26)|(100,26),(100,27)|(101,27),(101,35)|
(6,1),(7,1)|(7,2),(14,2)|(6,4),(14,4)|(4,5),(6,5)|(4,6),(14,6)|(6,8),(14,8)|(14,9),(16,9)|(9,10),(14,10)|(16,10),(17,10)|(9,12),(17,12)|(9,14),(17,14)|(4,16),(6,16)|(9,16),(17,16)|(4,17),(6,17)|(6,18),(19,18)|(74,19),(84,19)|(85,19),(89,19)|(91,19),(95,19)|(74,20),(84,20)|(85,20),(89,20)|(91,20),(95,20)|(67,21),(68,21)|(23,22),(24,22)|(30,22),(31,22)|(37,22),(38,22)|(43,22),(44,22)|(64,22),(67,22)|(48,23),(53,23)|(74,23),(89,23)|(90,23),(95,23)|(6,24),(19,24)|(45,24),(48,24)|(53,24),(55,24)|(89,24),(90,24)|(7,25),(19,25)|(21,25),(22,25)|(28,25),(29,25)|(35,25),(36,25)|(41,25),(42,25)|(55,25),(57,25)|(62,25),(64,25)|(73,25),(74,25)|(95,25),(96,25)|(19,26),(21,26)|(25,26),(28,26)|(32,26),(35,26)|(39,26),(41,26)|(57,26),(62,26)|(68,26),(96,26)|(59,27),(60,27)|(70,27),(71,27)|(100,27),(101,27)|(59,28),(60,28)|(70,28),(71,28)|(19,30),(56,30)|(4,31),(6,31)|(7,31),(19,31)|(56,31),(58,31)|(4,32),(58,32)|
(24,22),(25,23)|(31,22),(32,23)|(38,22),(39,23)|(44,22),(45,23)|
(22,23),(23,22)|(29,23),(30,22)|(36,23),(37,22)|(42,23),(43,22)|(72,26),(73,25)|
(23.5,20),(23.5,22)|(30.5,20),(30.5,22)|(37.5,17),(37.5,22)|(43.5,20),(43.5,22)|(89.5,16),(89.5,19)|(89.5,20),(89.5,23)|(90.5,18),(90.5,19)|(90.5,20),(90.5,23)|
(6,11.5),(6,14.5)|(9,11.5),(9,14.5)|
end file : HI_B07