Pièce : HI_B15
taille : 104x35
########################################################################################################
########################################################################################################
###############################=########################################################################
###############################.#####################################################=########=#########
#######=#######################.#####################################################.########.#########
#######.#######################.#####################################################.########.#########
#######.#######################.#####################################################.########.#########
#######.#######################.#############################################.........########.#########
#######.#######################.#############################################.################.#########
###............=#######=...####.#############################################.################.#########
###.######################.####.#####################################.#######.################.#########
###.######################.####.###################################....######.##############...#########
###.######################.####.######.........###################.......####.##############...#########
###.######################.####.######..........################..........#......##########....#########
###.######################.####.#####..............########.........................######....##########
###.######################.####.............................................###..............###########
###.######################.############......#####################......################################
###.######################.############......#####################......###################=############
###.######################.############-.....#####################......################################
###...........############.############......#####################......################################
#############.##########...........####-.....#####################......################################
#############.##########.#######...####......######################....#################################
#############.##########.########..####.....#######################...##################################
#############.##########.#########.#####...#########################..##################################
#############.##########.#########=######.###########################.##################################
#############.#######.......#############.###########################.##################################
#############.#####.........#############.#########......############.##################################
###########=................###########=..#########.####.############.##################################
######################.....##############.#########.####.###########..##################################
######################.....##############.#########.####.########.....##################################
#######################...###############...........####.######........=################################
########################.################.##############..#####.########################################
########################.################.##############........########################################
########################..................###############......#########################################
########################################################################################################
(3,9),(3,20)|(4,10),(4,19)|(7,4),(7,9)|(8,4),(8,9)|(11,27),(11,28)|(13,20),(13,27)|(14,19),(14,27)|(16,9),(16,10)|(19,26),(19,27)|(21,25),(21,26)|(22,28),(22,30)|(23,9),(23,10)|(23,30),(23,31)|(24,20),(24,25)|(24,31),(24,34)|(25,21),(25,25)|(25,31),(25,33)|(26,10),(26,20)|(26,30),(26,31)|(27,9),(27,20)|(27,28),(27,30)|(28,25),(28,28)|(31,2),(31,16)|(32,2),(32,15)|(32,21),(32,22)|(33,22),(33,23)|(34,23),(34,25)|(35,20),(35,25)|(37,14),(37,15)|(38,12),(38,14)|(39,16),(39,23)|(39,27),(39,28)|(40,23),(40,24)|(41,24),(41,27)|(41,28),(41,33)|(42,24),(42,30)|(42,31),(42,34)|(43,23),(43,24)|(44,22),(44,23)|(45,16),(45,22)|(47,12),(47,13)|(48,13),(48,14)|(51,14),(51,15)|(51,26),(51,30)|(52,27),(52,31)|(56,27),(56,33)|(57,26),(57,31)|(57,33),(57,34)|(58,31),(58,32)|(59,14),(59,15)|(63,30),(63,32)|(63,33),(63,34)|(64,13),(64,14)|(64,31),(64,33)|(65,29),(65,30)|(66,12),(66,13)|(66,16),(66,21)|(67,11),(67,12)|(67,21),(67,23)|(68,23),(68,24)|(68,28),(68,29)|(69,10),(69,11)|(69,24),(69,28)|(70,10),(70,11)|(70,22),(70,30)|(71,11),(71,12)|(71,21),(71,22)|(72,16),(72,21)|(72,30),(72,31)|(73,12),(73,13)|(74,13),(74,14)|(75,13),(75,14)|(76,15),(76,16)|(77,7),(77,13)|(78,8),(78,13)|(79,15),(79,16)|(81,13),(81,14)|(84,14),(84,15)|(85,3),(85,7)|(86,3),(86,8)|(90,14),(90,15)|(91,13),(91,14)|(91,17),(91,18)|(92,11),(92,13)|(92,17),(92,18)|(93,15),(93,16)|(94,3),(94,11)|(94,14),(94,15)|(95,3),(95,14)|
(31,2),(32,2)|(85,3),(86,3)|(94,3),(95,3)|(7,4),(8,4)|(77,7),(85,7)|(78,8),(86,8)|(3,9),(7,9)|(8,9),(16,9)|(23,9),(27,9)|(4,10),(16,10)|(23,10),(26,10)|(69,10),(70,10)|(67,11),(69,11)|(70,11),(71,11)|(92,11),(94,11)|(38,12),(47,12)|(66,12),(67,12)|(71,12),(73,12)|(47,13),(48,13)|(64,13),(66,13)|(73,13),(74,13)|(75,13),(77,13)|(78,13),(81,13)|(91,13),(92,13)|(37,14),(38,14)|(48,14),(51,14)|(59,14),(64,14)|(74,14),(75,14)|(81,14),(84,14)|(90,14),(91,14)|(94,14),(95,14)|(32,15),(37,15)|(51,15),(59,15)|(76,15),(79,15)|(84,15),(90,15)|(93,15),(94,15)|(31,16),(39,16)|(45,16),(66,16)|(72,16),(76,16)|(79,16),(93,16)|(91,17),(92,17)|(91,18),(92,18)|(4,19),(14,19)|(3,20),(13,20)|(24,20),(26,20)|(27,20),(35,20)|(25,21),(32,21)|(66,21),(67,21)|(71,21),(72,21)|(32,22),(33,22)|(44,22),(45,22)|(70,22),(71,22)|(33,23),(34,23)|(39,23),(40,23)|(43,23),(44,23)|(67,23),(68,23)|(40,24),(41,24)|(42,24),(43,24)|(68,24),(69,24)|(21,25),(24,25)|(25,25),(28,25)|(34,25),(35,25)|(19,26),(21,26)|(51,26),(57,26)|(11,27),(13,27)|(14,27),(19,27)|(39,27),(41,27)|(52,27),(56,27)|(11,28),(22,28)|(27,28),(28,28)|(39,28),(41,28)|(68,28),(69,28)|(65,29),(68,29)|(22,30),(23,30)|(26,30),(27,30)|(42,30),(51,30)|(63,30),(65,30)|(70,30),(72,30)|(23,31),(24,31)|(25,31),(26,31)|(42,31),(52,31)|(57,31),(58,31)|(64,31),(72,31)|(58,32),(63,32)|(25,33),(41,33)|(56,33),(57,33)|(63,33),(64,33)|(24,34),(42,34)|(57,34),(63,34)|