Pièce : HI_B03
taille : 110x35
##########....................................................................................................
##########....................................................................................................
##########....................................................................................................
##########....................................................................................................
##########....................................................................................................
##########....................................................................................................
##########....................................................................................................
##########....................................................................................................
#######......................................................................................................#
#####=...................................................................................................#####
#######..................................................................................................#####
#####=..........|........................................................................................#####
#######.........|........................................................................................#####
#########.......|........................................................................................#####
#########.......|......................................................................................#######
############....|......................................................................................#######
############....|....................................####................................................#####
############....|....................................####................................................#####
############....|....................................####.......................................|........#####
############....|....................................####.......................................|........#####
############....|..............####.............................................................|..|.....#####
############....|..............####..........................................................|..|..|....######
############....|..............####.......................................##.....####........|..|..|...#######
############....|..............####.......................................##...#######.......|..|..|..########
#############...|.......|......................................##############################H##H##H##########
#############...|.......|................##########............###############################################
###############.|.......|................##########............###############################################
#################.......|................###########..........################################################
###################.....|..#.............############........#################################################
#####################...|#####.......#################......##################################################
##############################################################################################################
#####################=###########=#=######################=###################################################
##############################################################################################################
##############################################################################################################
##############################################################################################################
(5,9),(5,10)|(5,11),(5,12)|(7,8),(7,9)|(7,10),(7,11)|(7,12),(7,13)|(9,13),(9,15)|(10,0),(10,8)|(12,15),(12,24)|(13,24),(13,26)|(15,26),(15,27)|(17,27),(17,28)|(19,28),(19,29)|(21,29),(21,30)|(21,31),(21,32)|(22,31),(22,32)|(25,29),(25,30)|(27,28),(27,29)|(28,28),(28,29)|(30,29),(30,30)|(31,20),(31,24)|(33,31),(33,32)|(34,31),(34,32)|(35,20),(35,24)|(35,31),(35,32)|(36,31),(36,32)|(37,29),(37,30)|(41,25),(41,29)|(51,25),(51,27)|(52,27),(52,28)|(53,16),(53,20)|(53,28),(53,29)|(54,29),(54,30)|(57,16),(57,20)|(58,31),(58,32)|(59,31),(59,32)|(60,29),(60,30)|(61,28),(61,29)|(62,27),(62,28)|(63,24),(63,27)|(74,22),(74,24)|(76,22),(76,24)|(79,23),(79,24)|(81,22),(81,23)|(85,22),(85,23)|(86,23),(86,24)|(93,24),(93,25)|(94,24),(94,25)|(96,24),(96,25)|(97,24),(97,25)|(99,24),(99,25)|(100,24),(100,25)|(102,23),(102,24)|(103,14),(103,16)|(103,22),(103,23)|(104,21),(104,22)|(105,9),(105,14)|(105,16),(105,21)|(109,8),(109,9)|
(7,7),(10,8)|(109,109),(110,8)|(5,5),(7,9)|(105,105),(109,9)|(5,5),(7,10)|(5,5),(7,11)|(5,5),(7,12)|(7,7),(9,13)|(103,103),(105,14)|(9,9),(12,15)|(53,53),(57,16)|(103,103),(105,16)|(31,31),(35,20)|(53,53),(57,20)|(104,104),(105,21)|(74,74),(76,22)|(81,81),(85,22)|(103,103),(104,22)|(79,79),(81,23)|(85,85),(86,23)|(102,102),(103,23)|(12,12),(13,24)|(31,31),(35,24)|(63,63),(74,24)|(76,76),(79,24)|(86,86),(93,24)|(94,94),(96,24)|(97,97),(99,24)|(100,100),(102,24)|(41,41),(51,25)|(93,93),(94,25)|(96,96),(97,25)|(99,99),(100,25)|(13,13),(15,26)|(15,15),(17,27)|(51,51),(52,27)|(62,62),(63,27)|(17,17),(19,28)|(27,27),(28,28)|(52,52),(53,28)|(61,61),(62,28)|(19,19),(21,29)|(25,25),(27,29)|(28,28),(30,29)|(37,37),(41,29)|(53,53),(54,29)|(60,60),(61,29)|(21,21),(25,30)|(30,30),(37,30)|(54,54),(60,30)|(21,21),(22,31)|(33,33),(34,31)|(35,35),(36,31)|(58,58),(59,31)|(21,21),(22,32)|(33,33),(34,32)|(35,35),(36,32)|(58,58),(59,32)|


(16.5,11),(16.5,27)|(24.5,24),(24.5,30)|(93.5,21),(93.5,24)|(96.5,18),(96.5,24)|(99.5,20),(99.5,24)|

end file : HI_B03