Pièce : HI_C13
taille : 152x35
########################################################################################################################################################
########################################################################################################################################################
########################################################################################################################################################
########################################################################################################################################################
########################################################################################################################################################
########################################################################################################################################################
########################################################################################################################################################
########################################################################################################################################################
########################################################################################################################################################
#####.........................................####....................####....................####....................####.....................#########
########################################################################################################################################################
########################################################################################################################################################
#####.............................................................................................................................................######
###=...............................................................................................................................................=####
#####.............................................................................................................................................######
###=...............................................................................................................................................=####
#####.............................................................................................../#/......../#/..../#//#/......................######
###=.................................................../#/./#/.../#/................................###........###....######.......................=####
#####.........###................................###...###.###...###...............................######....../#/..../#//#/#.............#.......######
##################/............................######.#/#/./#/..#/#/....../#############################################################################
#############################################################################=#=#=#=#=#=#=#=#=##########################################################
########################################################################################################################################################
########################################################################################################################################################
########################################################################################################################################################
########################################################################################################################################################
########################################################################################################################################################
########################################################################################################################################################
########################################################################################################################################################
########################################################################################################################################################
########################################################################################################################################################
########################################################################################################################################################
########################################################################################################################################################
########################################################################################################################################################
########################################################################################################################################################
########################################################################################################################################################
(3,13),(3,14)|(3,15),(3,16)|(3,17),(3,18)|(5,9),(5,10)|(5,12),(5,13)|(5,14),(5,15)|(5,16),(5,17)|(5,18),(5,19)|(14,18),(14,19)|(17,18),(17,19)|(46,9),(46,10)|(47,19),(47,20)|(49,18),(49,19)|(50,9),(50,10)|(52,18),(52,19)|(53,19),(53,20)|(54,19),(54,20)|(64,19),(64,20)|(70,9),(70,10)|(74,9),(74,10)|(77,20),(77,21)|(78,20),(78,21)|(79,20),(79,21)|(80,20),(80,21)|(81,20),(81,21)|(82,20),(82,21)|(83,20),(83,21)|(84,20),(84,21)|(85,20),(85,21)|(86,20),(86,21)|(87,20),(87,21)|(88,20),(88,21)|(89,20),(89,21)|(90,20),(90,21)|(91,20),(91,21)|(92,20),(92,21)|(93,20),(93,21)|(94,9),(94,10)|(94,20),(94,21)|(98,9),(98,10)|(99,18),(99,19)|(100,18),(103,18)|(105,18),(105,19)|(118,9),(118,10)|(122,9),(122,10)|(125,18),(125,19)|(138,18),(138,19)|(139,18),(139,19)|(143,9),(143,10)|(146,12),(146,13)|(146,14),(146,15)|(146,16),(146,17)|(146,18),(146,19)|(148,13),(148,14)|(148,15),(148,16)|(148,17),(148,18)|
(5,9),(46,9)|(50,9),(70,9)|(74,9),(94,9)|(98,9),(118,9)|(122,9),(143,9)|(5,10),(46,10)|(50,10),(70,10)|(74,10),(94,10)|(98,10),(118,10)|(122,10),(143,10)|(5,12),(146,12)|(3,13),(5,13)|(146,13),(148,13)|(3,14),(5,14)|(146,14),(148,14)|(3,15),(5,15)|(146,15),(148,15)|(3,16),(5,16)|(146,16),(148,16)|(3,17),(5,17)|(146,17),(148,17)|(3,18),(5,18)|(14,18),(17,18)|(49,18),(52,18)|(99,18),(100,18)|(103,18),(105,18)|(125,18),(138,18)|(139,18),(146,18)|(148,18),(5,19)|(14,19),(17,19)|(47,19),(49,19)|(52,19),(53,19)|(54,19),(64,19)|(99,19),(105,19)|(125,19),(138,19)|(139,19),(146,19)|(47,20),(53,20)|(54,20),(64,20)|(77,20),(78,20)|(79,20),(80,20)|(81,20),(82,20)|(83,20),(84,20)|(85,20),(86,20)|(87,20),(88,20)|(89,20),(90,20)|(91,20),(92,20)|(93,20),(94,20)|(77,21),(78,21)|(79,21),(80,21)|(81,21),(82,21)|(83,21),(84,21)|(85,21),(86,21)|(87,21),(88,21)|(89,21),(90,21)|(91,21),(92,21)|(93,21),(94,21)|(18,19),(19,20)|(57,17),(58,18)|(57,19),(58,20)|(61,17),(62,18)|(61,19),(62,20)|(67,17),(68,18)|(67,19),(68,20)|(102,16),(103,17)|(113,16),(114,17)|(113,18),(114,19)|(120,16),(121,17)|(120,18),(121,19)|(123,16),(124,17)|(55,18),(56,17)|(55,20),(56,19)|(59,18),(60,17)|(59,20),(60,19)|(65,18),(66,17)|(65,20),(66,19)|(74,20),(75,19)|(100,17),(101,16)|(111,17),(112,16)|(111,19),(112,18)|(118,17),(119,16)|(118,19),(119,18)|(121,17),(122,16)|(121,19),(122,18)|(123,19),(124,18)|