Pièce : HI_C13
taille : 152x35
########################################################################################################################################################
########################################################################################################################################################
########################################################################################################################################################
########################################################################################################################################################
########################################################################################################################################################
########################################################################################################################################################
########################################################################################################################################################
########################################################################################################################################################
########################################################################################################################################################
#####.........................................####....................####....................####....................####.....................#########
########################################################################################################################################################
########################################################################################################################################################
#####.............................................................................................................................................######
###=...............................................................................................................................................=####
#####.............................................................................................................................................######
###=...............................................................................................................................................=####
#####.............................................................................................../#/......../#/..../#//#/......................######
###=.................................................../#/./#/.../#/................................###........###....######.......................=####
#####.........###................................###...###.###...###...............................######....../#/..../#//#/#.............#.......######
##################/............................######.#/#/./#/..#/#/....../#############################################################################
#############################################################################=#=#=#=#=#=#=#=#=##########################################################
########################################################################################################################################################
########################################################################################################################################################
########################################################################################################################################################
########################################################################################################################################################
########################################################################################################################################################
########################################################################################################################################################
########################################################################################################################################################
########################################################################################################################################################
########################################################################################################################################################
########################################################################################################################################################
########################################################################################################################################################
########################################################################################################################################################
########################################################################################################################################################
########################################################################################################################################################
46,9|50,9|70,9|74,9|94,9|98,9|118,9|122,9|143,9|5,10|46,10|50,10|70,10|74,10|94,10|98,10|118,10|122,10|143,10|5,12|146,12|5,13|146,13|5,15|5,14|146,15|146,14|5,17|5,16|101,16|100,17|103,17|102,16|112,16|111,17|114,17|113,16|119,16|118,17|121,17|120,16|122,16|121,17|124,17|123,16|146,17|146,16|56,17|55,18|58,18|57,17|60,17|59,18|62,18|61,17|66,17|65,18|68,18|67,17|5,18|14,18|17,18|49,18|52,18|99,18|100,18|103,18|105,18|112,18|111,19|114,19|113,18|119,18|118,19|121,19|120,18|122,18|121,19|124,18|123,19|125,18|139,18|138,18|146,18|5,19|14,19|17,19|19,20|18,19|47,19|49,19|52,19|53,19|54,19|56,19|55,20|58,20|57,19|60,19|59,20|62,20|61,19|64,19|66,19|65,20|68,20|67,19|75,19|74,20|99,19|105,19|125,19|139,19|138,19|146,19|47,20|53,20|54,20|64,20|