Pièce : HI_C02
taille : 54x121
######################################################
######################################################
#####.........####..####..##..##..##..################
##################..####..##..##..##..################
##################..####..............################
##################..####..............################
##################..####..............################
#####...............####..............################
#####...............####..............################
########################..............################
########################..............################
########################..............################
########################...........................###
#####...#.....#....................................###
#####..............................................###
#####..............................................###
###=.........................|.....................###
#####........................|.........######......###
###=...............|.........|.......###=##=#......###
#####..............|......|..|.........######...|..###
#########..........|..|...|..|.........######...|..###
#########..........|..|...|..|..................|.####
#####..............|..|...|#.|..................|#####
#####.###..........|..|..#####..................######
#####.#############H##H###H##H########################
#####.#############=##=###=###########################
#####.################################################
#####.################################################
#####......|......#############................=######
#####......|......#############...............########
#####.####.|......#############.....##################
#####.####.|......#|##|###|##|#.....##################
#####.#######......|..|...|..|....####################
#####.###..#.......|..|...|..|................########
#####.###..........|..|...|..|........################
#####.###..........|..|...|..|........################
#####.###..........|..|...|..|........################
#####.###..........|..|...|..|........################
#####..............|..|...|..|.......#####.........###
###########........|..|...|..|........####..##########
###########...........|...|..|........####..##########
#########.............|.##H##H##......####..##########
#########.............|.##=##=##......####..##########
#####.................|.########......####..####...###
#####.................|./######/......####..####...###
#####..............|..|...#..#........####..####...###
#####..............|..|...............####..####...###
#####..............|..|...............####..####...###
#####..............|..|...............####..####...###
###########......##H##H##.............####..####...###
#####.#####......##=##=##............#####..####...###
#####.#####......########.............####..####...###
#####.#####....../######/.............####..####...###
#####.###..........#..#..............#####..####...###
#####.###...........................######..####...###
#####.####.......................#####################
#####.###.....................----=###################
#####.###........................#####################
#####.###.....................-----###################
#####.###........................#####################
#####.........................----=###################
#########.............###........#####################
#############H##H#####################################
##########...|..|..###################################
##########...|..|..##############################|####
#########....|..|.....................####..####.|.###
#########....|..|.....................####..####.|.###
#####........|..|........######.......####..####.|.###
#####........|..|........#=##=#.......####..####.|.###
###=.........|..|........######.......####..####...###
#####........|..|........######.......####..####...###
###=.........|..|.........|..........#####..####...###
#####........|..|.........|.........######..####...###
##########...|..|....#####################..####...###
#########....|..|....#####################..####...###
#########....|..|....#####################..####...###
#########....|..|....#####################..####...###
#########....|..|....####...................####...###
#####........|..|....####...................####...###
#####.###....####....####...................####...###
#####.###....####....####...................####...###
#####.###....####....####...................####...###
#####.###....####....####...................####...###
#####.###....|..|....####...................####...###
#####.###....|..|....####...................####...###
#####.###....|..|...######..................####...###
#####.###.......|...######..................####...###
#####.###.......|...######..................####...###
#####.###.......|...######..................####...###
#####.###.......|...#=##=#..................####...###
#####...........|...#|##|#..................####...###
#########....|..|....|..|...................####...###
#########....|..|....|..|..................#####...###
#####.......###.|....|..|.................######...###
#####.######################..........################
#####.##########.####.##.##............##########.####
#####.##########.####.##.##............##########.####
#####.##########.####.##.##............##########.####
#####.##########......##.##............##########.####
#####.##########.####.##.##............##########.####
#####.##########.####.##.##............##########.####
#####.##########.####+##+##............##########.####
#####............##..|..|.................#######.####
#########.######.##..|..|.................#######.####
#########.######.##..|..|.................#######.####
#########.######.##..|..|.................#######.####
#########.######.##..|..|.................#######.####
#########.######.##..|..|.................#######.####
#########.######.##..|..#.................#######.####
####=.....######.....|#####............##.........####
######################################################
#############################=#=#=#=#=################
######################################################
######################################################
######################################################
######################################################
######################################################
######################################################
######################################################
######################################################
######################################################
(3,16),(3,17)|(3,18),(3,19)|(3,69),(3,70)|(3,71),(3,72)|(4,109),(4,110)|(5,2),(5,3)|(5,7),(5,9)|(5,13),(5,16)|(5,17),(5,18)|(5,19),(5,20)|(5,22),(5,39)|(5,43),(5,49)|(5,50),(5,61)|(5,67),(5,69)|(5,70),(5,71)|(5,72),(5,73)|(5,78),(5,91)|(5,93),(5,103)|(6,23),(6,28)|(6,30),(6,38)|(6,50),(6,60)|(6,79),(6,90)|(6,94),(6,102)|(8,13),(8,14)|(9,13),(9,14)|(9,20),(9,22)|(9,23),(9,24)|(9,33),(9,38)|(9,41),(9,43)|(9,53),(9,55)|(9,56),(9,60)|(9,61),(9,62)|(9,65),(9,67)|(9,74),(9,78)|(9,79),(9,90)|(9,91),(9,93)|(9,103),(9,109)|(10,30),(10,32)|(10,55),(10,56)|(10,63),(10,65)|(10,73),(10,74)|(10,103),(10,110)|(11,33),(11,34)|(11,39),(11,41)|(11,49),(11,53)|(12,33),(12,34)|(12,93),(12,94)|(13,32),(13,33)|(14,2),(14,3)|(14,13),(14,14)|(15,13),(15,14)|(15,93),(15,94)|(16,95),(16,102)|(16,103),(16,110)|(17,49),(17,95)|(17,98),(17,99)|(17,109),(18,2)|(18,7),(18,28)|(18,32),(19,26)|(19,51),(19,53)|(19,54),(19,63)|(19,65),(19,102)|(19,109),(20,2)|(20,9),(20,26)|(20,51),(20,53)|(20,54),(20,85)|(20,91),(21,73)|(21,85),(21,89)|(21,95),(21,98)|(21,99),(22,26)|(22,51),(22,53)|(22,54),(22,61)|(22,62),(22,89)|(22,95),(23,26)|(23,51),(23,53)|(23,54),(24,2)|(24,13),(24,41)|(24,89),(24,95)|(24,109),(25,23)|(25,24),(25,49)|(25,61),(25,62)|(25,67),(25,71)|(25,77),(25,85)|(25,89),(25,95)|(25,109),(26,2)|(26,4),(26,26)|(26,43),(26,45)|(26,46),(26,68)|(26,69),(26,85)|(26,91),(27,26)|(27,43),(27,45)|(27,46),(27,68)|(27,69),(27,95)|(27,102),(27,109)|(27,110),(28,2)|(28,4),(28,22)|(28,23),(28,94)|(28,95),(29,43)|(29,45),(29,46)|(29,68),(29,69)|(29,111),(29,112)|(30,2),(30,4)|(30,43),(30,45)|(30,46),(30,68)|(30,69),(30,111)|(30,112),(31,28)|(31,32),(31,67)|(31,71),(31,111)|(31,112),(32,2)|(32,4),(32,41)|(32,111),(32,112)|(33,55),(33,62)|(33,111),(33,112)|(34,2),(34,4)|(34,32),(34,33)|(34,111),(34,112)|(35,56),(35,57)|(35,60),(35,61)|(35,111),(35,112)|(36,2),(36,4)|(36,30),(36,32)|(36,54),(36,55)|(36,72),(36,73)|(36,111),(36,112)|(37,18),(37,19)|(37,38),(37,39)|(37,50),(37,51)|(37,53),(37,54)|(37,71),(37,72)|(37,111),(37,112)|(38,2),(38,12)|(38,34),(38,38)|(38,39),(38,50)|(38,51),(38,53)|(38,65),(38,71)|(38,94),(38,95)|(38,111),(38,112)|(39,17),(39,18)|(39,19),(39,21)|(39,95),(39,102)|(39,109),(39,110)|(40,18),(40,19)|(41,18),(41,19)|(41,109),(41,110)|(42,38),(42,55)|(42,65),(42,77)|(42,93),(42,94)|(42,102),(42,109)|(43,18),(43,19)|(43,92),(43,93)|(44,18),(44,19)|(44,39),(44,55)|(44,65),(44,92)|(45,17),(45,21)|(46,29),(46,30)|(46,33),(46,34)|(48,24),(48,28)|(48,29),(48,43)|(48,55),(48,65)|(48,94),(49,95)|(49,109),(50,21)|(50,22),(50,95)|(50,110),(51,12)|(51,21),(51,38)|(51,39),(51,43)|(51,55),(51,65)|
(5,2),(14,2)|(18,2),(20,2)|(24,2),(26,2)|(28,2),(30,2)|(32,2),(34,2)|(36,2),(38,2)|(5,3),(14,3)|(26,4),(28,4)|(30,4),(32,4)|(34,4),(36,4)|(5,7),(18,7)|(5,9),(20,9)|(38,12),(51,12)|(5,13),(8,13)|(9,13),(14,13)|(15,13),(24,13)|(8,14),(9,14)|(14,14),(15,14)|(3,16),(5,16)|(3,17),(5,17)|(39,17),(45,17)|(3,18),(5,18)|(37,18),(39,18)|(40,18),(41,18)|(43,18),(44,18)|(3,19),(5,19)|(37,19),(39,19)|(40,19),(41,19)|(43,19),(44,19)|(5,20),(9,20)|(39,21),(45,21)|(50,21),(51,21)|(5,22),(9,22)|(28,22),(50,22)|(6,23),(9,23)|(25,23),(28,23)|(9,24),(25,24)|(48,24),(19,26)|(20,26),(22,26)|(23,26),(26,26)|(27,26),(6,28)|(18,28),(31,28)|(48,28),(46,29)|(48,29),(6,30)|(10,30),(36,30)|(46,30),(10,32)|(13,32),(18,32)|(31,32),(34,32)|(36,32),(9,33)|(11,33),(12,33)|(13,33),(34,33)|(46,33),(11,34)|(12,34),(38,34)|(46,34),(6,38)|(9,38),(37,38)|(38,38),(42,38)|(51,38),(5,39)|(11,39),(37,39)|(38,39),(44,39)|(51,39),(9,41)|(11,41),(24,41)|(32,41),(5,43)|(9,43),(26,43)|(27,43),(29,43)|(30,43),(48,43)|(51,43),(26,45)|(27,45),(29,45)|(30,45),(26,46)|(27,46),(29,46)|(30,46),(5,49)|(11,49),(17,49)|(25,49),(5,50)|(6,50),(37,50)|(38,50),(19,51)|(20,51),(22,51)|(23,51),(37,51)|(38,51),(9,53)|(11,53),(19,53)|(20,53),(22,53)|(23,53),(37,53)|(38,53),(19,54)|(20,54),(22,54)|(23,54),(36,54)|(37,54),(9,55)|(10,55),(33,55)|(36,55),(42,55)|(44,55),(48,55)|(51,55),(9,56)|(10,56),(35,56)|(35,57),(6,60)|(9,60),(35,60)|(5,61),(9,61)|(22,61),(25,61)|(35,61),(9,62)|(22,62),(25,62)|(33,62),(10,63)|(19,63),(9,65)|(10,65),(19,65)|(38,65),(42,65)|(44,65),(48,65)|(51,65),(5,67)|(9,67),(25,67)|(31,67),(26,68)|(27,68),(29,68)|(30,68),(3,69)|(5,69),(26,69)|(27,69),(29,69)|(30,69),(3,70)|(5,70),(3,71)|(5,71),(25,71)|(31,71),(37,71)|(38,71),(3,72)|(5,72),(36,72)|(37,72),(5,73)|(10,73),(21,73)|(36,73),(9,74)|(10,74),(25,77)|(42,77),(5,78)|(9,78),(6,79)|(9,79),(20,85)|(21,85),(25,85)|(26,85),(21,89)|(22,89),(24,89)|(25,89),(6,90)|(9,90),(5,91)|(9,91),(20,91)|(26,91),(43,92)|(44,92),(5,93)|(9,93),(12,93)|(15,93),(42,93)|(43,93),(6,94)|(12,94),(15,94)|(28,94),(38,94)|(42,94),(48,94)|(51,94),(16,95)|(17,95),(21,95)|(22,95),(24,95)|(25,95),(27,95)|(28,95),(38,95)|(39,95),(49,95)|(50,95),(17,98)|(21,98),(17,99)|(21,99),(6,102)|(16,102),(19,102)|(27,102),(39,102)|(42,102),(5,103)|(9,103),(10,103)|(16,103),(4,109)|(9,109),(17,109)|(19,109),(24,109)|(25,109),(27,109)|(39,109),(41,109)|(42,109),(49,109)|(4,110),(10,110)|(16,110),(27,110)|(39,110),(41,110)|(50,110),(29,111)|(30,111),(31,111)|(32,111),(33,111)|(34,111),(35,111)|(36,111),(37,111)|(38,111),(29,112)|(30,112),(31,112)|(32,112),(33,112)|(34,112),(35,112)|(36,112),(37,112)|