Pièce : HI_D01
taille : 208x35
####################################################################......................................................................................................######################################
#####################################################################...................................................................................................########################################
######################################################################..............................................................................................##.#########################################
###########################################################################...........................####................................#.####..................####=#########################################
#############################################################################################################...........................###=####################################################################
#################################################################################################################......................#########################################################################
#################################################################################################################------.........-----###########################################################################
#################################################################################################################...................############################################################################
#########=..................=########=.............................................................................................###########...........................=######################################
###################################################################################################################---.........----#############################################################################
###########.#####################################################################################################...................###################################.########################################
########....................###=#=####................###.................................................................................###......................####......................###################
###############################|#|#######################..........................................................................................................#############################################
#######........................|.|...........................................................................................................................................................###################
#####=.........................|..............................................................................................................................................................=#################
#######........................|.............................................................................................................................................................###################
#####=........................................................................................................................................................................................=#################
#######......................................................................................................................................................................................###################
#####=..............####......................................................................................................................................................................=#################
#######............######............................................................................................................................................................####....###################
##########################/................................................................................###...................................................................../############################
###########################/...........................#####..............................................#######.................######........................................../#############################
######################################################################################################################...........###############################################################################
#######################################################################################################################..........###############################################################################
#######################################################################################################################-------##################################################################################
######################################################################################################################.......###################################################################################
####################################################################################################################........####################################################################################
###############################################################################################################------....---####################################################################################
###############################################################...###########################################.................###........#######################################################################
###############################################################......................................##.........................................##..........................####################################
###############################################################......................................##.........................................##..........................####################################
################################################################.............................................................................................................###################################
################################################################..............................................................................................................##################################
################################################################..............................................................................................................##################################
###############################################################..............................................................................................................###################################
69,1|168,1|170,1|69,2|70,2|164,2|166,2|167,2|168,2|70,3|75,3|102,3|106,3|139,3|138,3|140,3|144,3|162,3|164,3|75,4|102,4|106,4|109,4|136,4|138,4|144,4|162,4|109,5|113,5|135,5|136,5|135,6|113,8|142,8|131,8|132,8|11,10|12,10|113,10|132,10|142,9|167,10|168,10|8,11|11,11|12,11|28,11|38,11|54,11|57,11|113,11|132,11|138,11|141,11|163,11|168,11|189,11|138,12|141,12|7,13|8,12|28,12|38,12|54,12|57,13|163,13|167,12|189,13|189,12|7,14|189,14|7,16|7,15|189,16|189,15|7,18|7,17|189,18|189,17|20,18|24,18|7,19|19,19|20,19|24,19|25,19|181,19|185,19|189,19|7,20|19,20|25,20|26,20|107,20|110,20|180,20|181,20|185,20|189,20|28,22|55,21|60,21|106,21|107,21|110,21|113,21|130,21|136,21|178,22|55,22|60,22|106,22|113,22|118,22|129,22|130,22|136,22|118,23|119,23|118,25|129,24|116,26|118,26|124,26|125,26|63,28|66,28|109,28|126,28|129,28|137,28|66,29|101,29|103,29|109,29|126,29|129,29|137,29|144,29|146,29|172,29|101,31|103,31|144,31|146,31|172,31|173,31|63,31|64,31|173,32|174,32|63,34|64,34|173,34|174,34|