Piece : SS_LAB4
48x35
1312x351
################################################
################################################
###########.......#########=#=#####...##########
#########=----.....########|#|##..........-=####
###########.........#####..|.|............######
########|..................|..............######
######....................................######
######....................................|..###
#####........................................###
####..........................................##
####..........................................##
####...........................................#
####...........................................#
####...........................................#
####...........................................#
####...........................................#
####...........................................#
####...........................................#
####...........................................#
####...........................................#
####...........................................#
####..........................................##
####..........................................##
####..........................................##
####..........................................##
####..........................................##
####..........................................##
#####|..|....................................###
######..|.................................|.####
##########................|...............######
##########..........##....|...............######
########=--.......######.#|#####-----------=####
##########......########=#=#####..........######
################################################
################################################
(4,9),(4,27)|(5,8),(5,9)|(5,27),(5,28)|(6,6),(6,8)|(6,28),(6,29)|(8,5),(8,6)|(8,31),(8,32)|(9,3),(9,4)|(10,29),(10,31)|(10,32),(10,33)|(11,2),(11,3)|(11,4),(11,5)|(16,32),(16,33)|(18,2),(18,3)|(18,31),(18,32)|(19,3),(19,4)|(20,4),(20,5)|(20,30),(20,31)|(22,30),(22,31)|(24,31),(24,33)|(25,4),(25,5)|(25,31),(25,33)|(26,31),(26,33)|(27,2),(27,4)|(27,31),(27,33)|(28,2),(28,4)|(29,2),(29,4)|(30,2),(30,4)|(32,3),(32,4)|(32,31),(32,33)|(35,2),(35,3)|(38,2),(38,3)|(42,4),(42,7)|(42,29),(42,31)|(42,32),(42,33)|(44,3),(44,4)|(44,28),(44,29)|(44,31),(44,32)|(45,7),(45,9)|(45,27),(45,28)|(46,9),(46,11)|(46,21),(46,27)|(47,11),(47,21)|
(11,2),(18,2)|(27,2),(28,2)|(29,2),(30,2)|(35,2),(38,2)|(9,3),(11,3)|(18,3),(19,3)|(32,3),(35,3)|(38,3),(44,3)|(9,4),(11,4)|(19,4),(20,4)|(25,4),(27,4)|(28,4),(29,4)|(30,4),(32,4)|(42,4),(44,4)|(8,5),(11,5)|(20,5),(25,5)|(6,6),(8,6)|(42,7),(45,7)|(5,8),(6,8)|(4,9),(5,9)|(45,9),(46,9)|(46,11),(47,11)|(46,21),(47,21)|(4,27),(5,27)|(45,27),(46,27)|(5,28),(6,28)|(44,28),(45,28)|(6,29),(10,29)|(42,29),(44,29)|(20,30),(22,30)|(8,31),(10,31)|(18,31),(20,31)|(22,31),(24,31)|(25,31),(26,31)|(27,31),(32,31)|(42,31),(44,31)|(8,32),(10,32)|(16,32),(18,32)|(42,32),(44,32)|(10,33),(16,33)|(24,33),(25,33)|(26,33),(27,33)|(32,33),(42,33)|
None|
None|
(5.5,27),(5.5,28)|(8.5,5),(8.5,6)|(8.5,27),(8.5,29)|(26.5,29),(26.5,32)|(27.5,3),(27.5,6)|(29.5,3),(29.5,5)|(42.5,7),(42.5,8)|(42.5,28),(42.5,29)|
(10,3.5),(14,3.5)|(42,3.5),(43,3.5)|(9,31.5),(11,31.5)|(32,31.5),(43,31.5)|
end file : SS_LAB4