Pièce : SI_C06
taille : 48x120
################################################
################################################
################################################
##################............../###############
##################.............../##############
##################................/#############
##################.................#############
##################.................#############
##################..................=###########
##################.................#############
##################..................=###########
##################.................#############
##################.................#############
##################.................#############
##################.................#############
##################.................#############
##################.................#############
##################.................#############
##################.................#############
##################.................#############
##################.................#############
##################.................#############
##################.................#############
##################.................#############
##################.................#############
##################.................#############
##################.................#############
################=...................=###########
##################....##...........#############
#############################HHHH###############
#############################|..|###############
###########################..|..|..#############
###########################..+--+..#############
###########################..|..|..#############
###########################.....|..#############
###########################..+--+..#############
###########################..|..|..#############
###########################..|..|..#############
###########################..+--+..#############
##########################/..|..+..#############
#########################/...|..|..#############
########################/....+--+..#############
######.......##.....##.......|..|..#############
######.......................|..|..#############
######.......................+--+..#############
######.......................|.....#############
######.......................|.....#############
######.......................|..|..#############
######.......................###################
######.................###..####################
#######................###..####################
#######.......###......###..####################
######........###...........####################
######........###...........####################
######......................####################
######......................####################
######......................####################
#######............................#############
######.............................#############
######............................##############
######............................##############
######.............................#############
######.............................#############
######.............................#############
#######............................#############
#######............................#############
######............................##############
######.........#........#........###############
########HHHH####################################
########|..|#################=#=################
########|..|####################################
########+--+####################################
########|..|####################################
########|..|####################################
########+--+####################################
########|..|####################################
########|..|####################################
########---+####################################
########...|####################################
########...|####################################
########+--+####################################
########|..|####################################
########|..|####################################
########+--+####################################
########|..|####################################
########|..|####################################
########+--+####################################
########|..|####################################
########|..|####################################
########+---####################################
########|...####################################
########|...####################################
########+---####################################
########|...####################################
########|...####################################
########+--+####################################
########|..|####################################
######..|..|.....###############################
######..|..|.........................###########
######.....|.........................###########
####=.....................................######
######.....................................=####
#######...................................######
#######....................................=####
########..................................######
##########.................................=####
########################..................######
########################..................######
#########............#####.............../######
################################################
################################################
################################################
################################################
################################################
################################################
################################################
################################################
################################################
################################################
################################################
(4,100),(4,101)|(6,42),(6,50)|(6,52),(6,57)|(6,58),(6,64)|(6,66),(6,68)|(6,97),(6,100)|(6,101),(6,102)|(7,50),(7,52)|(7,57),(7,58)|(7,64),(7,66)|(7,102),(7,104)|(8,68),(8,97)|(8,104),(8,105)|(9,108),(9,109)|(10,105),(10,106)|(12,68),(12,97)|(13,42),(13,43)|(14,51),(14,54)|(15,42),(15,43)|(15,67),(15,68)|(16,27),(16,28)|(16,67),(16,68)|(17,51),(17,54)|(17,97),(17,98)|(18,3),(18,27)|(18,28),(18,29)|(20,42),(20,43)|(21,108),(21,109)|(22,28),(22,29)|(22,42),(22,43)|(23,49),(23,52)|(24,28),(24,29)|(24,42),(24,67)|(24,68),(24,106)|(25,67),(25,68)|(26,49),(26,52)|(26,108),(26,109)|(27,31),(27,39)|(28,49),(28,57)|(29,29),(29,31)|(29,48),(29,49)|(29,69),(29,70)|(30,69),(30,70)|(31,69),(31,70)|(32,69),(32,70)|(33,29),(33,31)|(33,67),(33,68)|(34,59),(34,61)|(34,66),(34,67)|(35,8),(35,9)|(35,10),(35,11)|(35,27),(35,28)|(35,29),(35,31)|(35,48),(35,57)|(35,59),(35,61)|(37,8),(37,9)|(37,10),(37,11)|(37,27),(37,28)|(37,98),(37,100)|(42,100),(42,101)|(42,102),(42,103)|(42,104),(42,105)|(44,101),(44,102)|(44,103),(44,104)|(44,105),(44,106)|
(35,8),(37,8)|(35,9),(37,9)|(35,10),(37,10)|(35,11),(37,11)|(16,27),(18,27)|(35,27),(37,27)|(16,28),(18,28)|(22,28),(24,28)|(35,28),(37,28)|(18,29),(22,29)|(24,29),(29,29)|(33,29),(35,29)|(27,31),(29,31)|(33,31),(35,31)|(6,42),(13,42)|(15,42),(20,42)|(22,42),(24,42)|(13,43),(15,43)|(20,43),(22,43)|(29,48),(35,48)|(23,49),(26,49)|(28,49),(29,49)|(6,50),(7,50)|(14,51),(17,51)|(6,52),(7,52)|(23,52),(26,52)|(14,54),(17,54)|(6,57),(7,57)|(28,57),(35,57)|(6,58),(7,58)|(34,59),(35,59)|(34,61),(35,61)|(6,64),(7,64)|(6,66),(7,66)|(34,66),(35,66)|(15,67),(16,67)|(24,67),(25,67)|(33,67),(34,67)|(6,68),(8,68)|(12,68),(15,68)|(16,68),(24,68)|(25,68),(33,68)|(29,69),(30,69)|(31,69),(32,69)|(29,70),(30,70)|(31,70),(32,70)|(6,97),(8,97)|(12,97),(17,97)|(17,98),(37,98)|(4,100),(6,100)|(37,100),(42,100)|(4,101),(6,101)|(42,101),(44,101)|(6,102),(7,102)|(42,102),(44,102)|(42,103),(44,103)|(7,104),(8,104)|(42,104),(44,104)|(8,105),(10,105)|(42,105),(44,105)|(10,106),(24,106)|(42,106),(44,106)|(9,108),(21,108)|(24,108),(26,108)|(9,109),(21,109)|
(32,3),(35,6)|
(24,42),(27,39)|(41,109),(42,108)|
(8.5,69),(8.5,77)|(8.5,99),(11.5,69)|(11.5,89),(11.5,100)|(29.5,30),(29.5,34)|(29.5,48),(32.5,30)|(32.5,47),(32.5,48)|
(8,77.5),(12,89.5)|
end file : SI_C06