Pièce : SH_A19
taille : 48x35
################################################
################################################
################################################
#######################=########################
#######################|########################
#####################..|..######################
#####################..|..######################
#####################..|..######################
#####################..|..######################
#####################..|..######################
#####################..|..######################
#####################..|..######################
#####################..|..######################
#####################..|..######################
######........|..|.....|......|..|....|...######
######........|..|.....|......|..|....|...######
######........|..|.....|......|..|....|...######
######........|..|.....|......|..|........######
######........|..|.....|......####........######
######........|..|.....|....../##/........######
######........####.....|.......##.........######
######......../##/....................##..######
######.........##...................#####.######
######..............................############
######..............................############
######..............................#####.######
######.................|............#####.######
######.................|...........######.######
#######................|...........######.######
#########..............|............#####.######
################################################
###########=###########=########################
################################################
################################################
################################################
26,5|6,14|21,14|26,14|42,14|31,20|30,19|34,19|33,20|31,21|33,21|15,22|14,21|18,21|17,22|38,21|40,21|15,23|17,23|36,22|38,22|40,22|41,22|41,23|42,23|41,25|42,25|35,27|36,27|6,28|7,28|35,29|36,29|7,29|9,29|9,30|36,30|41,30|42,30|