Pièce : SH_A25
taille : 48x35
################################################
################################################
################################################
#####|##########################################
###..|..########################################
###..|..########################################
###..|..########################################
###..|..########################################
###..|..##..###.###.###.###.###.###....#########
###..|..##../#/.###./#/.###.###./#/..###########
###..|..##....../#/.....###./#/......###########
###..|..##............../#/............#########
###..|..##...........................###########
###..|..##...........................###########
###..|..##...................../#/.....#########
###..|..##..../#/..............###...###########
###..|..##....###............../#/...###########
###..|......../#/....../#/......|............###
###..|.........|.......###......|.............=#
###..|.........|......./#/......|............###
###..|.........|........|.......|.............=#
###..|........###.......|.......|............###
###..|..################H#######H###############
###..|..################=#######=###############
###..|..########################################
###..|..########################################
###..|..########################################
###..|..########################################
###..|..########################################
###..|..########################################
####.|..########################################
#####|.#########################################
#####H##########################################
#####=##########################################
################################################
(3,4),(3,30)|(4,30),(4,31)|(5,34),(6,34)|(7,31),(7,32)|(8,4),(8,17)|(8,22),(8,31)|(10,8),(10,17)|(12,8),(14,21)|(14,22),(15,8)|(16,8),(17,21)|(17,22),(19,8)|(20,8),(23,8)|(24,8),(24,24)|(25,24),(27,8)|(28,8),(31,8)|(32,8),(32,24)|(33,24),(35,8)|(37,9),(37,11)|(37,12),(37,14)|(37,15),(37,17)|(39,8),(39,9)|(39,11),(39,12)|(39,14),(39,15)|(45,17),(45,18)|(45,19),(45,20)|(45,21),(45,22)|(47,18),(47,19)|(47,20),(47,21)|
(3,4),(8,4)|(10,8),(12,8)|(15,8),(16,8)|(19,8),(20,8)|(23,8),(24,8)|(27,8),(28,8)|(31,8),(32,8)|(35,8),(39,8)|(37,9),(39,9)|(37,11),(39,11)|(37,12),(39,12)|(37,14),(39,14)|(37,15),(39,15)|(8,17),(10,17)|(37,17),(45,17)|(45,18),(47,18)|(45,19),(47,19)|(45,20),(47,20)|(14,21),(17,21)|(45,21),(47,21)|(8,22),(14,22)|(17,22),(45,22)|(24,24),(25,24)|(32,24),(33,24)|(3,30),(4,30)|(4,31),(7,31)|(8,31),(7,32)|(5,34),(6,34)|