Pièce : SH_A04
taille : 54x37
######################################################
######################################################
#################################H###H###H###H########
#############..H...H.............H...H...H...H.#######
############...H...H.............H...H...H...H..?#####
###########?###H###H###.......###H###H###H###H########
############...H...H.............H...H...H...H..######
############...H...H.............H...H...H...H..######
############.......H.............H...H...H...H..######
############.......H.................H...H...H..######
###########..........................H.......H..######
###########.....................................######
###########.............../#/...................######
###########............/#/###...................######
##########.........#...######....................#####
###########.......####.#######..........H.......######
#################################.......H....#########
#################################.......H.H..#.#######
#################################.......###..#+#######
###############/../#####/../####/......./#/...H.######
##############/..../###/..../##/....H...H#H...H.######
##############......###......##...H.H...H.H...H.######
##############......###......##...###...H.H...H.######
##############......###......##.../#/...H.H...H.######
##############......###......##...H#H...H.H...H..?####
##############......###......##...H.H...H.H...HH######
##############......###......##...H.H...###...H.######
##############......###...........H.H.../#/...H.######
##############......###.......##..H.H...H#H...H.######
##############......###......###..H.H...H.H...H..#####
##############......###......#####H.H...H.H...H.######
######################################################
######################################################
######################################################
######################################################
######################################################
######################################################
(10,14),(10,15)|(11,10),(11,14)|(11,15),(11,16)|(12,4),(12,10)|(13,3),(13,4)|(15,5),(15,6)|(16,5),(16,6)|(18,15),(18,16)|(19,5),(19,6)|(19,14),(19,15)|(20,5),(20,6)|(20,14),(20,15)|(22,15),(22,16)|(23,5),(23,6)|(23,16),(23,31)|(29,15),(29,27)|(29,29),(29,31)|(30,5),(30,6)|(30,15),(30,16)|(30,28),(30,29)|(32,28),(32,30)|(33,2),(33,3)|(33,5),(33,6)|(34,2),(34,3)|(34,5),(34,6)|(34,22),(34,30)|(37,2),(37,3)|(37,5),(37,6)|(38,2),(38,3)|(38,5),(38,6)|(40,18),(40,26)|(41,2),(41,3)|(41,5),(41,6)|(41,21),(41,29)|(42,2),(42,3)|(42,5),(42,6)|(42,21),(42,29)|(43,18),(43,26)|(45,2),(45,3)|(45,5),(45,6)|(45,16),(45,19)|(46,2),(46,3)|(46,5),(46,6)|(46,17),(46,19)|(47,3),(47,4)|(47,17),(47,19)|(48,6),(48,14)|(48,15),(48,16)|(48,19),(48,24)|(48,25),(48,29)|(48,30),(48,31)|(49,14),(49,15)|(49,29),(49,30)|
(33,2),(34,2)|(37,2),(38,2)|(41,2),(42,2)|(45,2),(46,2)|(13,3),(33,3)|(34,3),(37,3)|(38,3),(41,3)|(42,3),(45,3)|(46,3),(47,3)|(12,4),(13,4)|(15,5),(16,5)|(19,5),(20,5)|(23,5),(30,5)|(33,5),(34,5)|(37,5),(38,5)|(41,5),(42,5)|(45,5),(46,5)|(15,6),(16,6)|(19,6),(20,6)|(23,6),(30,6)|(33,6),(34,6)|(37,6),(38,6)|(41,6),(42,6)|(45,6),(46,6)|(11,10),(12,10)|(27,12),(28,12)|(24,13),(25,13)|(10,14),(11,14)|(19,14),(20,14)|(48,14),(49,14)|(10,15),(11,15)|(18,15),(19,15)|(20,15),(22,15)|(29,15),(30,15)|(48,15),(49,15)|(11,16),(18,16)|(22,16),(23,16)|(30,16),(33,16)|(45,16),(48,16)|(46,17),(47,17)|(40,18),(43,18)|(45,19),(46,19)|(47,19),(48,19)|(41,21),(42,21)|(34,22),(37,22)|(35,25),(36,25)|(40,26),(43,26)|(29,27),(31,27)|(30,28),(32,28)|(29,29),(30,29)|(41,29),(42,29)|(48,29),(49,29)|(32,30),(34,30)|(48,30),(49,30)|(14,31),(20,31)|(23,31),(29,31)|(34,31),(48,31)|
(18,19),(20,21)|(27,19),(29,21)|(28,12),(29,13)|(34,23),(35,24)|(40,19),(41,20)|(40,27),(41,28)|
(14,21),(16,19)|(23,14),(24,13)|(23,21),(25,19)|(31,21),(33,19)|(36,24),(37,23)|(42,20),(43,19)|(42,28),(43,27)|


end file : SH_A04