Pièce : SH_A16
taille : 48x35
################################################
################################################
################################################
#################################=##############
#################################|##############
####..|..|..|..|..|..|...........|..############
####..|..|..|..|..|..|...........|..############
##=......|..|..|..|..............|..############
####........|.....|..............|..############
##=.........|.....|..............|..############
#######...........|...#########..|..############
#######...............#########..|..############
####.....................######..|..############
####.....................######..|..############
####.....................######..|..############
###############################..|..############
#########=##=##=##=##=#########..|..############
###############################..|..############
###############################..|..############
###############################..|..############
###############################..|..############
###############################..|..############
###############################..|..############
###############################..|..############
###############################..|..############
####.............................|..############
####.............................|..############
####.............................|..############
##=..............................|..############
####.............................|..############
##########............###########H##############
##############.....##############=##############
################################################
################################################
################################################
(2,7),(2,8)|(2,9),(2,10)|(2,28),(2,29)|(4,5),(4,7)|(4,8),(4,9)|(4,12),(4,15)|(4,25),(4,28)|(4,29),(4,30)|(7,10),(7,12)|(9,16),(9,17)|(10,16),(10,17)|(10,30),(10,31)|(12,16),(12,17)|(13,16),(13,17)|(14,31),(14,32)|(15,16),(15,17)|(16,16),(16,17)|(18,16),(18,17)|(19,16),(19,17)|(19,31),(19,32)|(21,16),(21,17)|(22,10),(22,12)|(22,16),(22,17)|(22,30),(22,31)|(25,12),(25,15)|(31,10),(31,25)|(33,3),(33,32)|(34,3),(34,32)|(36,5),(36,30)|
(33,3),(34,3)|(4,5),(36,5)|(2,7),(4,7)|(2,8),(4,8)|(2,9),(4,9)|(2,10),(7,10)|(22,10),(31,10)|(4,12),(7,12)|(22,12),(25,12)|(4,15),(25,15)|(9,16),(10,16)|(12,16),(13,16)|(15,16),(16,16)|(18,16),(19,16)|(21,16),(22,16)|(9,17),(10,17)|(12,17),(13,17)|(15,17),(16,17)|(18,17),(19,17)|(21,17),(22,17)|(4,25),(31,25)|(2,28),(4,28)|(2,29),(4,29)|(4,30),(10,30)|(22,30),(36,30)|(10,31),(14,31)|(19,31),(22,31)|(14,32),(19,32)|(33,32),(34,32)|