Pièce : SH_A17
48x35
-529x-248
################################################
################################################
################################################
################################################
################################################
####......|..|.....|..|..|..|...|..|........####
####......|..|.....|..|..|..|...|..|........####
####......|..|.....|..|..|..|...|..|........####
##=.......|..|.....|..|..|..|...|..|.........=##
#####H#...|..|.....|..|..|......|..|.....#H#####
#####|#...|..|.....|..|.........|..|.....#|#####
#####|#...|..|.....|..|.........|..|.....#|#####
####.|....|..|.....|..|.........|..|......|.####
####.|....####.....|..|.........|..|......|.####
####.|..../##/.....|..|.........####......|.####
####.|.....##......|..|........./##/......|.####
####.|.............####..........##.......|.####
####.|............./##/.....................####
####.|..............##......................####
####.|......................................####
####..................................##########
####..................................##########
####..................................##########
####..................................##########
####..................................##########
####..................................##########
####.................................###########
####.................................###########
#####............................#....##########
######.........................####...##########
################################################
###################=#=#=#=######################
################################################
################################################
################################################
(2,8),(2,9)|(4,5),(4,8)|(4,12),(4,28)|(5,9),(5,12)|(5,28),(5,29)|(6,9),(6,12)|(6,29),(6,30)|(7,9),(7,12)|(10,13),(10,14)|(14,13),(14,14)|(19,16),(19,17)|(19,31),(19,32)|(20,19),(20,31)|(21,31),(21,32)|(22,19),(22,31)|(23,16),(23,17)|(23,31),(23,32)|(24,31),(24,32)|(25,31),(25,32)|(26,31),(26,32)|(31,29),(31,30)|(32,14),(32,15)|(33,17),(33,28)|(34,28),(34,29)|(35,17),(35,29)|(36,14),(36,15)|(37,26),(37,28)|(38,20),(38,26)|(38,28),(38,30)|(41,9),(41,12)|(42,9),(42,12)|(43,9),(43,12)|(44,5),(44,8)|(44,12),(44,20)|(46,8),(46,9)|
(4,5),(44,5)|(2,8),(4,8)|(44,8),(46,8)|(2,9),(5,9)|(6,9),(7,9)|(41,9),(42,9)|(43,9),(46,9)|(4,12),(5,12)|(6,12),(7,12)|(41,12),(42,12)|(43,12),(44,12)|(10,13),(14,13)|(32,14),(36,14)|(11,16),(13,16)|(19,16),(23,16)|(33,17),(35,17)|(20,19),(22,19)|(38,20),(44,20)|(37,26),(38,26)|(4,28),(5,28)|(33,28),(34,28)|(37,28),(38,28)|(5,29),(6,29)|(31,29),(33,29)|(34,29),(35,29)|(6,30),(31,30)|(35,30),(38,30)|(19,31),(20,31)|(21,31),(22,31)|(23,31),(24,31)|(25,31),(26,31)|(19,32),(20,32)|(21,32),(22,32)|(23,32),(24,32)|(25,32),(26,32)|
(10,14),(11,15)|(19,17),(20,18)|(32,15),(33,16)|
(13,15),(14,14)|(22,18),(23,17)|(35,16),(36,15)|
(5.5,10),(5.5,20)|(10.5,5),(10.5,13)|(13.5,5),(13.5,13)|(19.5,5),(19.5,16)|(22.5,5),(22.5,16)|(25.5,5),(25.5,10)|(28.5,5),(28.5,9)|(32.5,5),(32.5,14)|(35.5,5),(35.5,14)|(42.5,10),(42.5,17)|

end file : SH_A17