Pièce : SH_A26
taille : 54x35
######################################################
######################################################
######################################################
######################################################
######################################################
######################################################
######################################################
######################################################
######################################################
###############################.######################
###############################.######################
##############################..#############.########
#########=##=#################..############...#######
#########|##|###############.....########.....########
######...|..|................................#########
######...|..|................................#########
######...|..|................................#########
######...|..|................................#########
#########H##H##..............................#########
#########.##.##..............................#########
#########.##.##..............................#########
######.......................................#########
######.......................................#########
######.......................|...............#########
####=........................|...............#########
###############..............|..........|....#########
#########.##.##..............|..........|.....########
#########+##+##.......|......|..........|......=######
######...|..|.........|......|..........|.....########
######...|..|.........|......|..........|......=######
#######..|..|.........|......|..........|.....########
#######..|..|.........#......|..........|..###########
######################################################
######################################################
######################################################
(4,24),(4,25)|(6,14),(6,18)|(6,21),(6,24)|(6,28),(6,30)|(7,30),(7,32)|(9,12),(9,14)|(9,18),(9,21)|(9,26),(9,28)|(10,12),(10,14)|(10,18),(10,21)|(10,26),(10,28)|(12,12),(12,14)|(12,18),(12,21)|(12,26),(12,28)|(13,12),(13,14)|(13,18),(13,21)|(13,26),(13,28)|(15,18),(15,21)|(15,25),(15,28)|(22,31),(22,32)|(23,31),(23,32)|(28,13),(28,14)|(30,11),(30,13)|(31,9),(31,11)|(32,9),(32,13)|(33,13),(33,14)|(41,13),(41,14)|(43,31),(43,32)|(44,12),(44,13)|(45,11),(45,12)|(45,14),(45,26)|(46,11),(46,12)|(46,13),(46,14)|(46,26),(46,27)|(46,28),(46,29)|(46,30),(46,31)|(47,12),(47,13)|(48,27),(48,28)|(48,29),(48,30)|
(31,31),(32,9)|(30,30),(31,11)|(45,45),(46,11)|(9,9),(10,12)|(12,12),(13,12)|(44,44),(45,12)|(46,46),(47,12)|(28,28),(30,13)|(32,32),(33,13)|(41,41),(44,13)|(46,46),(47,13)|(6,6),(9,14)|(10,10),(12,14)|(13,13),(28,14)|(33,33),(41,14)|(45,45),(46,14)|(6,6),(9,18)|(10,10),(12,18)|(13,13),(15,18)|(6,6),(9,21)|(10,10),(12,21)|(13,13),(15,21)|(4,4),(6,24)|(4,4),(15,25)|(9,9),(10,26)|(12,12),(13,26)|(45,45),(46,26)|(46,46),(48,27)|(6,6),(9,28)|(10,10),(12,28)|(13,13),(15,28)|(46,46),(48,28)|(46,46),(48,29)|(6,6),(7,30)|(46,46),(48,30)|(22,22),(23,31)|(43,43),(46,31)|(7,7),(22,32)|(23,23),(43,32)|


(9.5,13),(9.5,18)|(9.5,32),(12.5,13)|(12.5,18),(12.5,32)|(22.5,27),(22.5,31)|(29.5,23),(29.5,32)|(40.5,25),(40.5,32)|

end file : SH_A26