Pièce : SH_C03
taille : 162x35
##....................................................................................................................................................############
###...................................................................................................................................................############
######...............................................................................................................................................#############
####..................................................................................................................................................############
##=..........###..............................##..................................#...................................................................############
#####......###########......................#######.............................####..................................................................############
#################=#=#################################################--...---##############-----##########--......--#############--.................##############
###################################################################=...--####################################---#############-.......................#############
###############################################################################################################################-.....................#############
#####.....................................................................................................................###......................###############
####................................................................................................................................................##############
#####...............................................................................................................................................##############
#######..............................................................................................................................................#############
#####...............................................................................................................................................##############
#####............................................................................................................................................#################
#####.............................................................................................................................................=###############
######............................................................................................................###...................#####....#################
######...................###########............................##################################################################################################
#####....................###########..............................################################################################################################
######...................###########...............................###############################################################################################
#########................############...........................................................................................................##################
#####=............|......############.......#######............................................................................................###################
#######...........|......###########.......########........|...................................................................................###################
########..........|.....############.......########........|................................................................................######################
########..........|.....############........#######........|...................................................................................###################
#########.........|......###########........#######........|..................................................................................####################
##########........|......###########........#######........|...................................................................................###################
############......|......###########........########.......|....................####............................................................=#################
#############.....|......############......#########.......|.#.........../#/....####............###..........###....................../#/.....####################
##############....|......############......########........|###..........###....####............################.............##.......###....#####################
###############...|......###########........#######........######.........#.....####............###..........###............#####......#...#######################
##################H###############################################################################################################################################
######################=#############################=##.############.#####################.#########################.####=#########=##############################
#######################################################..............................................................#############################################
##################################################################################################################################################################
(2,0),(2,1)|(2,4),(2,5)|(3,1),(3,2)|(4,3),(4,4)|(4,10),(4,11)|(5,5),(5,6)|(5,9),(5,10)|(5,11),(5,12)|(5,13),(5,16)|(5,18),(5,19)|(5,21),(5,22)|(6,2),(6,3)|(6,16),(6,18)|(6,19),(6,20)|(7,12),(7,13)|(7,22),(7,23)|(8,23),(8,25)|(9,20),(9,21)|(9,25),(9,26)|(10,26),(10,27)|(11,5),(11,6)|(12,27),(12,28)|(13,4),(13,5)|(13,28),(13,29)|(14,29),(14,30)|(15,30),(15,31)|(16,4),(16,5)|(17,6),(17,7)|(18,6),(18,7)|(18,31),(18,32)|(19,6),(19,7)|(19,31),(19,32)|(20,6),(20,7)|(22,5),(22,6)|(22,32),(22,33)|(23,32),(23,33)|(24,23),(24,25)|(25,17),(25,23)|(25,25),(25,31)|(36,17),(36,20)|(36,22),(36,28)|(36,30),(36,31)|(37,20),(37,22)|(37,28),(37,30)|(43,22),(43,24)|(43,28),(43,30)|(44,5),(44,6)|(44,21),(44,22)|(44,24),(44,28)|(44,30),(44,31)|(46,4),(46,5)|(48,4),(48,5)|(51,5),(51,6)|(51,21),(51,27)|(51,29),(51,31)|(52,27),(52,29)|(52,32),(52,33)|(53,32),(53,33)|(55,32),(55,34)|(56,32),(56,33)|(59,30),(59,31)|(60,29),(60,30)|(61,28),(61,29)|(62,28),(62,29)|(63,29),(63,30)|(64,17),(64,18)|(65,30),(65,31)|(66,18),(66,19)|(67,7),(67,8)|(67,19),(67,20)|(68,32),(68,33)|(69,6),(69,7)|(69,32),(69,33)|(73,7),(73,8)|(74,30),(74,31)|(75,30),(75,31)|(77,6),(77,7)|(80,5),(80,6)|(80,27),(80,31)|(82,4),(82,5)|(83,4),(83,5)|(84,5),(84,6)|(84,27),(84,31)|(90,32),(90,33)|(91,6),(91,7)|(91,32),(91,33)|(96,6),(96,7)|(96,28),(96,31)|(99,28),(99,29)|(99,30),(99,31)|(106,6),(106,7)|(109,7),(109,8)|(109,28),(109,29)|(109,30),(109,31)|(112,7),(112,8)|(112,28),(112,31)|(114,16),(114,17)|(116,6),(116,7)|(116,32),(116,33)|(117,16),(117,17)|(117,32),(117,34)|(121,32),(121,33)|(122,9),(122,10)|(122,32),(122,33)|(124,30),(124,31)|(125,7),(125,8)|(125,9),(125,10)|(125,29),(125,30)|(127,8),(127,9)|(127,29),(127,30)|(129,6),(129,7)|(129,30),(129,31)|(131,32),(131,33)|(132,32),(132,33)|(135,30),(135,31)|(136,16),(136,17)|(136,30),(136,31)|(139,30),(139,31)|(140,23),(140,24)|(141,16),(141,17)|(141,29),(141,30)|(142,25),(142,26)|(142,28),(142,29)|(143,21),(143,23)|(143,24),(143,25)|(143,26),(143,27)|(144,20),(144,21)|(145,14),(145,15)|(145,16),(145,17)|(145,27),(145,28)|(147,9),(147,10)|(147,15),(147,16)|(148,6),(148,7)|(148,10),(148,12)|(148,13),(148,14)|(149,2),(149,3)|(149,7),(149,9)|(149,12),(149,13)|(150,0),(150,2)|(150,3),(150,6)|
(2,2),(150,0)|(2,2),(3,1)|(3,3),(6,2)|(149,149),(150,2)|(4,4),(6,3)|(149,149),(150,3)|(2,2),(4,4)|(13,13),(16,4)|(46,46),(48,4)|(82,82),(83,4)|(2,2),(5,5)|(11,11),(13,5)|(16,16),(22,5)|(44,44),(46,5)|(48,48),(51,5)|(80,80),(82,5)|(83,83),(84,5)|(5,5),(11,6)|(17,17),(18,6)|(19,19),(20,6)|(22,22),(44,6)|(51,51),(69,6)|(77,77),(80,6)|(84,84),(91,6)|(96,96),(106,6)|(116,116),(129,6)|(148,148),(150,6)|(17,17),(18,7)|(19,19),(20,7)|(67,67),(69,7)|(73,73),(77,7)|(91,91),(96,7)|(106,106),(109,7)|(112,112),(116,7)|(125,125),(129,7)|(148,148),(149,7)|(67,67),(73,8)|(109,109),(112,8)|(125,125),(127,8)|(5,5),(122,9)|(125,125),(127,9)|(147,147),(149,9)|(4,4),(5,10)|(122,122),(125,10)|(147,147),(148,10)|(4,4),(5,11)|(5,5),(7,12)|(148,148),(149,12)|(5,5),(7,13)|(148,148),(149,13)|(145,145),(148,14)|(145,145),(147,15)|(5,5),(6,16)|(114,114),(117,16)|(136,136),(141,16)|(145,145),(147,16)|(25,25),(36,17)|(64,64),(114,17)|(117,117),(136,17)|(141,141),(145,17)|(5,5),(6,18)|(64,64),(66,18)|(5,5),(6,19)|(66,66),(67,19)|(6,6),(9,20)|(36,36),(37,20)|(67,67),(144,20)|(5,5),(9,21)|(44,44),(51,21)|(143,143),(144,21)|(5,5),(7,22)|(36,36),(37,22)|(43,43),(44,22)|(7,7),(8,23)|(24,24),(25,23)|(140,140),(143,23)|(43,43),(44,24)|(140,140),(143,24)|(8,8),(9,25)|(24,24),(25,25)|(142,142),(143,25)|(9,9),(10,26)|(142,142),(143,26)|(10,10),(12,27)|(51,51),(52,27)|(80,80),(84,27)|(143,143),(145,27)|(12,12),(13,28)|(36,36),(37,28)|(43,43),(44,28)|(61,61),(62,28)|(96,96),(99,28)|(109,109),(112,28)|(142,142),(145,28)|(13,13),(14,29)|(51,51),(52,29)|(60,60),(61,29)|(62,62),(63,29)|(99,99),(109,29)|(125,125),(127,29)|(141,141),(142,29)|(14,14),(15,30)|(36,36),(37,30)|(43,43),(44,30)|(59,59),(60,30)|(63,63),(65,30)|(73,73),(74,30)|(75,75),(76,30)|(99,99),(109,30)|(124,124),(125,30)|(127,127),(129,30)|(134,134),(135,30)|(136,136),(137,30)|(139,139),(141,30)|(15,15),(18,31)|(19,19),(25,31)|(36,36),(44,31)|(51,51),(59,31)|(65,65),(74,31)|(75,75),(80,31)|(84,84),(96,31)|(99,99),(109,31)|(112,112),(124,31)|(129,129),(135,31)|(136,136),(139,31)|(18,18),(19,32)|(22,22),(23,32)|(52,52),(53,32)|(55,55),(56,32)|(68,68),(69,32)|(90,90),(91,32)|(116,116),(117,32)|(121,121),(122,32)|(131,131),(132,32)|(22,22),(23,33)|(52,52),(53,33)|(56,56),(68,33)|(69,69),(90,33)|(91,91),(116,33)|(121,121),(122,33)|(131,131),(132,33)|(55,55),(117,34)|
(75,28),(76,29)|(136,28),(137,29)|
(73,29),(74,28)|(134,29),(135,28)|
(18.5,21),(18.5,31)|(59.5,22),(59.5,30)|
(69,6.5),(71,6.5)|(71,7.5),(73,7.5)|(74,6.5),(77,6.5)|(91,6.5),(96,6.5)|(106,6.5),(108,6.5)|(109,7.5),(112,7.5)|(114,6.5),(116,6.5)|(125,7.5),(126,7.5)|(127,8.5),(128,8.5)|(129,6.5),(131,6.5)|
end file : SH_C03