Pièce : SH_C09
taille : 152x35
########################################################################################################################################################
########################################################################################################################################################
########################################################################################################################################################
########################################################################################################################################################
##################################################################################################.............####............................#########
##################################################################################################.............####............................#########
##################################################################################################.............####.............................=#######
###################################################################################################............####............................#########
###################################################################################################################................##H##################
###################################################################################################################................##|##################
###################################################################################################################..................|.#################
###################################################################################################################..................|.#################
###################################################################################################..................................|.#################
##################################################################################################...................................|.#################
##################################################################################################...................................|.#################
##################################################################################################...................................|.#################
##################################################################################################...................................|.#################
#####................................................................................................................................|.#################
#####..................................................................................................................................#################
#####............................../#/......../#/............................................................../#/............/#/......#################
###=...............................###........###......................................................./#/....###...../#/....###......#################
#####...........###............##../#/.....###/#/.......................##..................##..........###..../#/.....###..../#/......#################
##################################################################################################....../#/............/#/.............#################
##################################################################################################.....................................#################
###################################################################################################...................................##################
####################################################################################################................................####################
########################################################################################################################################################
#########################################################################################################=######=#######=######=########################
########################################################################################################################################################
########################################################################################################################################################
########################################################################################################################################################
########################################################################################################################################################
########################################################################################################################################################
########################################################################################################################################################
########################################################################################################################################################
3,20|3,21|5,17|5,20|5,21|5,22|16,21|16,22|19,21|19,22|31,21|31,22|33,21|33,22|35,20|35,22|36,19|36,21|37,19|37,21|38,20|38,22|43,21|43,22|46,20|46,22|47,19|47,21|48,19|48,21|49,20|49,22|72,21|72,22|74,21|74,22|92,21|92,22|94,21|94,22|98,4|98,7|98,13|98,17|98,22|98,24|99,7|99,8|99,12|99,13|99,24|99,25|100,25|100,26|104,21|104,22|105,20|105,23|105,27|105,28|106,20|106,23|106,27|106,28|107,21|107,22|111,4|111,8|111,20|111,21|112,19|112,22|112,27|112,28|113,19|113,22|113,27|113,28|114,20|114,21|115,4|115,12|119,21|119,22|120,20|120,23|120,27|120,28|121,20|121,23|121,27|121,28|122,21|122,22|126,20|126,21|127,19|127,22|127,27|127,28|128,19|128,22|128,27|128,28|129,20|129,21|131,8|131,10|132,25|132,26|134,24|134,25|135,10|135,24|143,4|143,6|143,7|143,8|145,6|145,7|
(3,20),(3,21)|(5,17),(5,20)|(5,21),(5,22)|(16,21),(16,22)|(19,21),(19,22)|(31,21),(31,22)|(33,21),(33,22)|(35,20),(35,22)|(36,19),(36,21)|(37,19),(37,21)|(38,20),(38,22)|(43,21),(43,22)|(46,20),(46,22)|(47,19),(47,21)|(48,19),(48,21)|(49,20),(49,22)|(72,21),(72,22)|(74,21),(74,22)|(92,21),(92,22)|(94,21),(94,22)|(98,4),(98,7)|(98,13),(98,17)|(98,22),(98,24)|(99,7),(99,8)|(99,12),(99,13)|(99,24),(99,25)|(100,25),(100,26)|(104,21),(104,22)|(105,20),(105,23)|(105,27),(105,28)|(106,20),(106,23)|(106,27),(106,28)|(107,21),(107,22)|(111,4),(111,8)|(111,20),(111,21)|(112,19),(112,22)|(112,27),(112,28)|(113,19),(113,22)|(113,27),(113,28)|(114,20),(114,21)|(115,4),(115,12)|(119,21),(119,22)|(120,20),(120,23)|(120,27),(120,28)|(121,20),(121,23)|(121,27),(121,28)|(122,21),(122,22)|(126,20),(126,21)|(127,19),(127,22)|(127,27),(127,28)|(128,19),(128,22)|(128,27),(128,28)|(129,20),(129,21)|(131,8),(131,10)|(132,25),(132,26)|(134,24),(134,25)|(135,10),(135,24)|(143,4),(143,6)|(143,7),(143,8)|(145,6),(145,7)|
(98,4),(111,4)|(115,4),(143,4)|(143,6),(145,6)|(98,7),(99,7)|(143,7),(145,7)|(99,8),(111,8)|(131,8),(143,8)|(131,10),(135,10)|(99,12),(115,12)|(98,13),(99,13)|(5,17),(98,17)|(36,19),(37,19)|(47,19),(48,19)|(112,19),(113,19)|(127,19),(128,19)|(3,20),(5,20)|(35,20),(38,20)|(46,20),(49,20)|(105,20),(106,20)|(111,20),(114,20)|(120,20),(121,20)|(126,20),(129,20)|(3,21),(5,21)|(16,21),(19,21)|(31,21),(33,21)|(36,21),(37,21)|(43,21),(47,21)|(48,21),(72,21)|(74,21),(92,21)|(94,21),(104,21)|(107,21),(111,21)|(114,21),(119,21)|(122,21),(126,21)|(129,21),(5,22)|(16,22),(19,22)|(31,22),(33,22)|(35,22),(38,22)|(43,22),(46,22)|(49,22),(72,22)|(74,22),(92,22)|(94,22),(98,22)|(104,22),(107,22)|(112,22),(113,22)|(119,22),(122,22)|(127,22),(128,22)|(105,23),(106,23)|(120,23),(121,23)|(98,24),(99,24)|(134,24),(135,24)|(99,25),(100,25)|(132,25),(134,25)|(100,26),(132,26)|(105,27),(106,27)|(112,27),(113,27)|(120,27),(121,27)|(127,27),(128,27)|(105,28),(106,28)|(112,28),(113,28)|(120,28),(121,28)|(127,28),(128,28)|