Pièce : SH_C10
taille : 152x35
########################################################################################################################################################
########################################################################################################################################################
####=........................................=###########=....................................=##############=.....................................=####
########################################################################################################################################################
#####..............................................................................................................................................#####
###=................................................................................................................................................=###
#####..............................................................................................................................................#####
###=................................................................................................##..............................................=###
#####...........##....................................####.........................................#####...................................####....#####
############################################################/.............../###########################################################################
###################################################################################.##.##.######################.###.###.###############################
##############################################################=###=###=###=########.##.##.######################.###.###.###############################
################################################################################...................................................................#####
################################################################################...................................................................#####
##############################################################################=....................................................##...............=###
########################################################################################################################################################
################################################################################################################=###=###=###############################
########################################################################################################################################################
########################################################################################################################################################
########################################################################################################################################################
########################################################################################################################################################
########################################################################################################################################################
########################################################################################################################################################
########################################################################################################################################################
########################################################################################################################################################
########################################################################################################################################################
########################################################################################################################################################
########################################################################################################################################################
########################################################################################################################################################
########################################################################################################################################################
########################################################################################################################################################
########################################################################################################################################################
########################################################################################################################################################
########################################################################################################################################################
########################################################################################################################################################
(3,5),(3,6)|(3,7),(3,8)|(4,2),(4,3)|(5,4),(5,5)|(5,6),(5,7)|(5,8),(5,9)|(16,8),(16,9)|(18,8),(18,9)|(46,2),(46,3)|(54,8),(54,9)|(57,2),(57,3)|(58,8),(58,9)|(62,11),(62,12)|(63,11),(63,12)|(66,11),(66,12)|(67,11),(67,12)|(70,11),(70,12)|(71,11),(71,12)|(74,11),(74,12)|(75,11),(75,12)|(78,14),(78,15)|(80,12),(80,14)|(83,10),(83,12)|(84,10),(84,12)|(86,10),(86,12)|(87,10),(87,12)|(89,10),(89,12)|(90,10),(90,12)|(95,2),(95,3)|(99,8),(99,9)|(100,7),(100,8)|(102,7),(102,8)|(104,8),(104,9)|(109,2),(109,3)|(112,10),(112,12)|(112,16),(112,17)|(113,10),(113,12)|(113,16),(113,17)|(116,10),(116,12)|(116,16),(116,17)|(117,10),(117,12)|(117,16),(117,17)|(120,10),(120,12)|(120,16),(120,17)|(121,10),(121,12)|(121,16),(121,17)|(131,14),(131,15)|(133,14),(133,15)|(139,8),(139,9)|(143,8),(143,9)|(147,4),(147,5)|(147,6),(147,7)|(147,8),(147,9)|(147,12),(147,14)|(148,2),(148,3)|(149,5),(149,6)|(149,7),(149,8)|(149,14),(149,15)|
(4,2),(46,2)|(57,2),(95,2)|(109,2),(148,2)|(4,3),(46,3)|(57,3),(95,3)|(109,3),(148,3)|(5,4),(147,4)|(3,5),(5,5)|(147,5),(149,5)|(3,6),(5,6)|(147,6),(149,6)|(3,7),(5,7)|(100,7),(102,7)|(147,7),(149,7)|(3,8),(5,8)|(16,8),(18,8)|(54,8),(58,8)|(99,8),(100,8)|(102,8),(104,8)|(139,8),(143,8)|(147,8),(149,8)|(5,9),(16,9)|(18,9),(54,9)|(58,9),(99,9)|(104,9),(139,9)|(143,9),(147,9)|(83,10),(84,10)|(86,10),(87,10)|(89,10),(90,10)|(112,10),(113,10)|(116,10),(117,10)|(120,10),(121,10)|(62,11),(63,11)|(66,11),(67,11)|(70,11),(71,11)|(74,11),(75,11)|(62,12),(63,12)|(66,12),(67,12)|(70,12),(71,12)|(74,12),(75,12)|(80,12),(83,12)|(84,12),(86,12)|(87,12),(89,12)|(90,12),(112,12)|(113,12),(116,12)|(117,12),(120,12)|(121,12),(147,12)|(78,14),(80,14)|(131,14),(133,14)|(147,14),(149,14)|(78,15),(131,15)|(133,15),(149,15)|(112,16),(113,16)|(116,16),(117,16)|(120,16),(121,16)|(112,17),(113,17)|(116,17),(117,17)|(120,17),(121,17)|