Pièce : SH_E05
taille : 252x35
####....................................................................................................................................................................................................................................####################
####.............................................................................................................................................................................................................................................###########
####..............................................................................................................................................................................................................................................##########
####..............................................................................................................................................................................................................................................##########
####..............|...............................................................................................................................................................................................................................##########
###...............|..|............................................................................................................................................................................................................................##########
#######....|......|..|..........|.................................................................................................................................................................................................................##########
#######....|......####..........|.................................................................................................................................................................................................................##########
####....|..|....../##/.......|..|.................................................................................................................................................................................................................##########
####....|..|......|##|...|...####.................................................................................................................................................................................................................##########
####....####......|..|...|.../##/.................................................................................................................................................................................................................##########
####..../##/......|..|...|...|##|....|............................................................................................................................................................................................................##########
####....|##|......|..|...|...|..|....|......#...........................................................................................###.......................................................................................................##########
####....|..|......|..|...|...|..|....|.....###..........................................................................................|.|........................................................................................................#########
####....|..|......|..|...|...|..|....|.....###..............................................................................###.........|.|.......................................................................................................##########
###.....|..|.....#################...|....#####.............................................................................##########..|.|.............................................................................##.........................#########
####....|..|.....#################...|...#######............................................................................###.....##..#|#.........................................................................########.........####.........##########
#####################################H###########..........##################..................#####.......................#################..............................................#########..............###########################################
#########.#########################################.......####################................########....................####################.................########.................###############.......##############################################
#########.......####################################---#######################----------------#########.......--###------######################---...--------###########----#-....-----#####################################################################
###############.###############################################################....#.........############..............##########################.............############...........#######################################################################
###############.#################################################################.####.......############.............##########################..........---##############........#########################################################################
#######......##.##...............######################################################-----##############--....-##--############################---........################-----###########################################################################
#######......##.##...............######################################################.....#############.........#..###########################.............################...############################################################################
#######..........................##############/......./##########/......./##########/......./##########/............######/......./##########/.............../###########......./##########/......./##########/......./####################################
#######......#####...............#############/........./########/........./########/........./########/............######/........./########/................./########/........./########/........./########/........./###################################
##############################################...........########...........########...........########.............######...........########...................########...........########...........########...........###################################
#############################.###############............########...........#######............########.............######...........########....................#######...........########...........########...........###################################
#############################.###############............########...........#######............########.............######...........########.....................######...........########...........########...........###################################
#############################.##############.............########...........######.............########.............######...........#######......................######...........########...........########...........###################################
#############################################............########...........######.............########............#######...........#######......................######...........########...........########...........###################################
#############################################............########...........########...........########...........########...........#######.....................#######...........########...........########...........###################################
#############################################............########...........#######............########...........########...........#######....................########...........########...........########...........###################################
#############################################............########...........#######............########...........########...........#######....................########...........########...........########...........###################################
##############################################...........########...........########...........########...........########...........########...................########...........########...........########...........###################################
(3,5),(3,6)|(3,15),(3,16)|(4,0),(4,5)|(4,8),(4,15)|(4,16),(4,17)|(7,6),(7,8)|(7,22),(7,26)|(9,13),(9,18)|(10,18),(10,19)|(13,22),(13,24)|(13,25),(13,26)|(15,20),(15,24)|(16,19),(16,24)|(17,15),(17,17)|(18,7),(18,22)|(18,24),(18,25)|(29,9),(29,27)|(30,12),(30,27)|(33,9),(33,22)|(34,15),(34,17)|(37,17),(37,18)|(38,17),(38,18)|(41,16),(41,17)|(42,15),(42,16)|(43,13),(43,15)|(44,12),(44,13)|(44,29),(44,30)|(45,12),(45,13)|(45,27),(45,29)|(45,30),(45,34)|(46,13),(46,15)|(46,27),(46,34)|(47,15),(47,16)|(48,16),(48,17)|(49,17),(49,18)|(51,18),(51,19)|(52,19),(52,20)|(55,19),(55,20)|(58,18),(58,19)|(59,17),(59,18)|(77,17),(77,18)|(78,18),(78,20)|(79,20),(79,21)|(81,21),(81,22)|(82,21),(82,22)|(82,29),(82,31)|(83,20),(83,21)|(83,27),(83,29)|(83,32),(83,34)|(84,20),(84,21)|(84,27),(84,31)|(84,32),(84,34)|(86,21),(86,22)|(87,22),(87,24)|(92,22),(92,24)|(93,20),(93,22)|(94,18),(94,20)|(95,17),(95,18)|(100,17),(100,18)|(102,18),(102,19)|(103,19),(103,20)|(105,20),(105,22)|(106,22),(106,23)|(112,19),(112,20)|(113,22),(113,23)|(114,23),(114,24)|(114,31),(114,35)|(115,19),(115,20)|(115,22),(115,24)|(115,30),(115,31)|(116,25),(116,30)|(117,22),(117,25)|(118,21),(118,22)|(119,20),(119,21)|(121,19),(121,20)|(122,18),(122,19)|(123,17),(123,18)|(124,14),(124,17)|(127,14),(127,15)|(127,16),(127,17)|(132,16),(132,17)|(134,15),(134,17)|(136,12),(136,13)|(136,16),(136,17)|(137,16),(137,17)|(138,16),(138,17)|(139,12),(139,13)|(139,16),(139,17)|(140,17),(140,18)|(140,29),(140,34)|(141,29),(141,34)|(142,18),(142,19)|(143,19),(143,20)|(144,21),(144,22)|(144,23),(144,24)|(145,20),(145,21)|(145,22),(145,23)|(156,22),(156,23)|(157,19),(157,20)|(157,21),(157,22)|(157,23),(157,24)|(158,20),(158,21)|(159,18),(159,19)|(160,27),(160,32)|(161,27),(161,28)|(161,31),(161,32)|(162,28),(162,31)|(167,18),(167,19)|(168,19),(168,20)|(170,20),(170,21)|(170,24),(170,25)|(171,21),(171,22)|(172,19),(172,20)|(172,22),(172,23)|(173,19),(173,20)|(173,23),(173,24)|(176,23),(176,24)|(177,22),(177,23)|(179,21),(179,22)|(181,20),(181,21)|(183,19),(183,20)|(184,18),(184,19)|(186,17),(186,18)|(195,17),(195,18)|(199,18),(199,19)|(206,18),(206,19)|(209,17),(209,18)|(212,16),(212,17)|(216,15),(216,16)|(218,15),(218,16)|(220,16),(220,17)|(229,16),(229,17)|(232,0),(232,1)|(233,16),(233,17)|(241,1),(241,2)|(242,2),(242,13)|(242,14),(242,15)|(242,16),(242,17)|(243,13),(243,14)|(243,15),(243,16)|
(4,4),(232,0)|(232,232),(241,1)|(241,241),(242,2)|(3,3),(4,5)|(3,3),(7,6)|(18,18),(22,7)|(4,4),(7,8)|(29,29),(33,9)|(8,8),(12,10)|(19,19),(21,10)|(30,30),(32,12)|(44,44),(45,12)|(136,136),(139,12)|(9,9),(11,13)|(43,43),(44,13)|(45,45),(46,13)|(136,136),(139,13)|(242,242),(243,13)|(124,124),(127,14)|(242,242),(243,14)|(3,3),(4,15)|(17,17),(34,15)|(42,42),(43,15)|(46,46),(47,15)|(127,127),(134,15)|(216,216),(218,15)|(242,242),(243,15)|(3,3),(4,16)|(41,41),(42,16)|(47,47),(48,16)|(127,127),(132,16)|(136,136),(137,16)|(138,138),(139,16)|(212,212),(216,16)|(218,218),(220,16)|(229,229),(233,16)|(242,242),(243,16)|(4,4),(17,17)|(34,34),(37,17)|(38,38),(41,17)|(48,48),(49,17)|(59,59),(77,17)|(95,95),(100,17)|(123,123),(124,17)|(127,127),(132,17)|(134,134),(136,17)|(137,137),(138,17)|(139,139),(140,17)|(186,186),(195,17)|(209,209),(212,17)|(220,220),(229,17)|(233,233),(242,17)|(9,9),(10,18)|(37,37),(38,18)|(49,49),(51,18)|(58,58),(59,18)|(77,77),(78,18)|(94,94),(95,18)|(100,100),(102,18)|(122,122),(123,18)|(140,140),(142,18)|(159,159),(167,18)|(184,184),(186,18)|(195,195),(199,18)|(206,206),(209,18)|(10,10),(16,19)|(51,51),(52,19)|(55,55),(58,19)|(102,102),(103,19)|(112,112),(115,19)|(121,121),(122,19)|(142,142),(143,19)|(157,157),(159,19)|(167,167),(168,19)|(172,172),(173,19)|(183,183),(184,19)|(199,199),(206,19)|(9,9),(15,20)|(52,52),(55,20)|(78,78),(79,20)|(83,83),(84,20)|(93,93),(94,20)|(103,103),(105,20)|(112,112),(115,20)|(119,119),(121,20)|(143,143),(145,20)|(157,157),(158,20)|(168,168),(170,20)|(172,172),(173,20)|(181,181),(183,20)|(79,79),(81,21)|(82,82),(83,21)|(84,84),(86,21)|(118,118),(119,21)|(144,144),(145,21)|(157,157),(158,21)|(170,170),(171,21)|(179,179),(181,21)|(7,7),(13,22)|(18,18),(33,22)|(81,81),(82,22)|(86,86),(87,22)|(92,92),(93,22)|(105,105),(106,22)|(113,113),(115,22)|(117,117),(118,22)|(144,144),(145,22)|(156,156),(157,22)|(171,171),(172,22)|(177,177),(179,22)|(105,105),(106,23)|(113,113),(114,23)|(144,144),(145,23)|(156,156),(157,23)|(172,172),(173,23)|(176,176),(177,23)|(13,13),(15,24)|(16,16),(18,24)|(87,87),(92,24)|(114,114),(115,24)|(144,144),(157,24)|(170,170),(173,24)|(13,13),(18,25)|(116,116),(117,25)|(7,7),(13,26)|(18,18),(33,26)|(29,29),(30,27)|(45,45),(46,27)|(83,83),(84,27)|(160,160),(161,27)|(161,161),(162,28)|(44,44),(45,29)|(82,82),(83,29)|(140,140),(141,29)|(29,29),(30,30)|(44,44),(45,30)|(115,115),(116,30)|(82,82),(84,31)|(114,114),(115,31)|(161,161),(162,31)|(83,83),(84,32)|(160,160),(161,32)|(45,45),(46,34)|(83,83),(84,34)|(140,140),(141,34)|(46,46),(57,35)|(65,65),(76,35)|(84,84),(95,35)|(103,103),(114,35)|(122,122),(133,35)|(141,141),(160,35)|(168,168),(179,35)|(187,187),(198,35)|(206,206),(217,35)|
(8,11),(9,12)|(18,8),(19,9)|(29,10),(30,11)|(55,24),(57,26)|(74,24),(76,26)|(93,24),(95,26)|(131,24),(133,26)|(158,24),(160,26)|(177,24),(179,26)|(196,24),(198,26)|(215,24),(217,26)|
(11,12),(12,11)|(21,9),(22,8)|(32,11),(33,10)|(46,26),(48,24)|(65,26),(67,24)|(84,26),(86,24)|(103,26),(105,24)|(122,26),(124,24)|(141,26),(143,24)|(168,26),(169,25)|(187,26),(189,24)|(206,26),(208,24)|
(8.5,8),(8.5,10)|(8.5,12),(8.5,17)|(11.5,6),(11.5,10)|(11.5,12),(11.5,17)|(18.5,4),(18.5,7)|(18.5,9),(18.5,15)|(21.5,5),(21.5,7)|(21.5,9),(21.5,15)|(25.5,9),(25.5,15)|(29.5,8),(29.5,9)|(29.5,11),(29.5,15)|(32.5,6),(32.5,9)|(32.5,11),(32.5,15)|(37.5,11),(37.5,17)|(136.5,13),(136.5,16)|(137.5,16),(137.5,17)|(138.5,13),(138.5,16)|
(52,19.5),(55,19.5)|(78,19.5),(87,22.5)|(92,22.5),(94,19.5)|(106,22.5),(108,22.5)|(110,19.5),(112,19.5)|(112,22.5),(113,22.5)|(115,19.5),(115,22.5)|(117,22.5),(121,19.5)|(143,19.5),(145,22.5)|(146,19.5),(148,22.5)|(149,19.5),(154,21.5)|(157,19.5),(157,21.5)|(168,19.5),(172,19.5)|(172,22.5),(173,19.5)|(174,19.5),(177,22.5)|(178,19.5),(183,19.5)|
end file : SH_E05