Pièce : SS_A04
taille : 48x35
################################################
###########.......................|......|.....#
###########.......................|......|.....#
##=########.......................|......|.....#
##.########....................#############...#
##.########--------------------#############---#
##.########....................#############...#
#...#######....................#############...#
#...#######....................#############...#
#...#######....................#############...#
#...#######.../###/../###/.....#############...#
#...#######...############.....#############...#
#---#######---############-----#############---#
#...#######...############.....#############...#
#...#######.../##########/........|......|.....#
#......|.......##########................|.....#
#......|.......##########................|.....#
#......|.......##########................|.....#
#......|.......##########................|...###
#.|....|.......##########................|...###
#.|....|.......##########................|...###
#.|....|.......##########................|.....#
#.#....|.......##########................|.....#
#.|....|.......##########................|.....#
#.|....|.......##########................|.....#
#####..|.......##########.........|......|.....#
#####..|.......##########.........|......|.....#
#####..|....../##########/........|.....########
#####..|......############........|.....########
#####..|......############........|..........=##
#####--+------############........|.....########
#####..|......############.......###....########
#####..##.....############.......###.........=##
#####--##-----############-------###....########
################################################
(1,7),(1,25)|(2,3),(2,7)|(2,22),(2,23)|(3,3),(3,7)|(3,22),(3,23)|(4,7),(4,15)|(5,25),(5,34)|(7,32),(7,34)|(9,32),(9,34)|(11,1),(11,15)|(31,4),(31,14)|(33,31),(33,34)|(36,31),(36,34)|(40,27),(40,29)|(40,30),(40,32)|(40,33),(40,34)|(44,4),(44,14)|(45,18),(45,21)|(46,29),(46,30)|(46,32),(46,33)|(47,1),(47,18)|(47,21),(47,27)|
(11,1),(47,1)|(2,3),(3,3)|(31,4),(44,4)|(1,7),(2,7)|(3,7),(4,7)|(31,14),(44,14)|(4,15),(11,15)|(45,18),(47,18)|(45,21),(47,21)|(2,22),(3,22)|(2,23),(3,23)|(1,25),(5,25)|(40,27),(47,27)|(40,29),(46,29)|(40,30),(46,30)|(33,31),(36,31)|(7,32),(9,32)|(40,32),(46,32)|(40,33),(46,33)|(5,34),(7,34)|(9,34),(14,34)|(26,34),(33,34)|(36,34),(40,34)|
(14,14),(15,15)|(18,10),(19,11)|(25,10),(26,11)|(25,27),(26,28)|
(14,11),(15,10)|(14,28),(15,27)|(21,11),(22,10)|(25,15),(26,14)|
(2.5,19),(2.5,22)|(2.5,23),(2.5,25)|(7.5,15),(7.5,32)|(34.5,1),(34.5,4)|(34.5,14),(34.5,15)|(34.5,25),(34.5,31)|(41.5,1),(41.5,4)|(41.5,14),(41.5,27)|
(1,12.5),(4,12.5)|(5,30.5),(5,33.5)|(7,33.5),(9,33.5)|(11,5.5),(11,12.5)|(14,12.5),(14,30.5)|(14,33.5),(26,12.5)|(26,33.5),(31,5.5)|(31,12.5),(33,33.5)|(44,5.5),(44,12.5)|(47,5.5),(47,12.5)|
end file : SS_A04