Pièce : SS_E06
taille : 252x35
############################################################################################################################################################################################################################################################
############################################################################################################################################################################################################################################################
############################################################################################################################################################################################################################################################
##############################################################################################################################=#######################################################################################################################..=###
##############################################################################################################################.#######################################################################################################################.#####
##############################################################################################################################.#######################################################################################################################.#####
##############################################################################################################################.#######################################################################################################################.#####
##############################/................/##############################################################################.#######################################################################################################################.#####
#####.....................................................---#####----................................---####------###########.#########..................----######----.............................................----#####----.................###.#####
#####..............................................................................................................###########.#########...........................................................................................................###.#####
#########---.......................................................................................................###########.#########...................................................................................................----#---+...#####
#####............................................................................................................#############.#########..........................................................................................................##########
#######......................................................................................................----#############.........+-------##------...........................................................................................##########
###########......................................................................................................#######################..............................................................................................---#--------+..=######
#############------##---...........................................................................................#####################..........................................................................................................##########
###########.......................................................................................................######################..........................................................................................................##########
####=..............................................................................................................#####################...........................................................................................................|.#######
###########.........................................................................................-----#---------+...#############...+------------..........................................................................................##############
############-----..................................................................................................#####################......................................................................................................##############
###########........................................................................................................#####################........................................................................................---#----------+......=######
#######..........................................................................................................########################.....................................................................................................##############
#####............................................................................................................########################---------............................................................................................##############
#######...................................................................................................-------+..........#############..........................................................................................................|.#######
#######---#-------...............................................................................................##########.#############..........................................................................................................|.#######
#######..........................................................................................................##########.############...........................................................................................................#########
#####...........................-----####-----................................---#####----.........................########.############--#----####----................................----#######----.............................................#########
###########################################################################################################################.################################################################################################################################
###########################################################################################################################.################################################################################################################################
###########################################################################################################################.################################################################################################################################
###########################################################################################################################.################################################################################################################################
###########################################################################################################################.################################################################################################################################
###########################################################################################################################=################################################################################################################################
############################################################################################################################################################################################################################################################
############################################################################################################################################################################################################################################################
############################################################################################################################################################################################################################################################
(4,16),(4,17)|(5,8),(5,10)|(5,11),(5,12)|(5,21),(5,22)|(5,25),(5,26)|(7,12),(7,13)|(7,20),(7,21)|(7,22),(7,25)|(9,10),(9,11)|(10,23),(10,24)|(11,13),(11,14)|(11,15),(11,16)|(11,17),(11,18)|(11,19),(11,20)|(11,23),(11,24)|(12,18),(12,19)|(13,14),(13,15)|(19,14),(19,15)|(21,14),(21,15)|(37,25),(37,26)|(41,25),(41,26)|(61,8),(61,9)|(66,8),(66,9)|(81,25),(81,26)|(86,25),(86,26)|(105,8),(105,9)|(105,17),(105,18)|(106,17),(106,18)|(109,8),(109,9)|(113,11),(113,14)|(113,20),(113,22)|(113,23),(113,25)|(114,15),(114,16)|(115,8),(115,11)|(115,14),(115,15)|(115,16),(115,17)|(115,18),(115,20)|(115,25),(115,26)|(119,17),(119,18)|(123,23),(123,32)|(124,22),(124,32)|(126,3),(126,13)|(127,3),(127,12)|(132,17),(132,18)|(136,8),(136,12)|(136,13),(136,17)|(136,18),(136,20)|(136,24),(136,26)|(137,20),(137,24)|(138,25),(138,26)|(139,25),(139,26)|(143,12),(143,13)|(143,25),(143,26)|(145,12),(145,13)|(147,25),(147,26)|(158,8),(158,9)|(164,8),(164,9)|(187,25),(187,26)|(194,25),(194,26)|(217,8),(217,9)|(222,8),(222,9)|(227,19),(227,20)|(228,19),(228,20)|(233,13),(233,14)|(234,13),(234,14)|(238,17),(238,19)|(238,20),(238,22)|(239,10),(239,11)|(240,10),(240,11)|(242,11),(242,13)|(242,14),(242,16)|(243,8),(243,10)|(243,24),(243,26)|(245,16),(245,17)|(245,22),(245,24)|(246,3),(246,10)|(246,13),(246,14)|(246,19),(246,20)|(247,4),(247,11)|(249,3),(249,4)|
(126,3),(127,3)|(246,3),(249,3)|(247,4),(249,4)|(5,8),(61,8)|(66,8),(105,8)|(109,8),(115,8)|(136,8),(158,8)|(164,8),(217,8)|(222,8),(243,8)|(61,9),(66,9)|(105,9),(109,9)|(158,9),(164,9)|(217,9),(222,9)|(5,10),(9,10)|(239,10),(240,10)|(243,10),(246,10)|(5,11),(9,11)|(113,11),(115,11)|(239,11),(240,11)|(242,11),(247,11)|(5,12),(7,12)|(127,12),(136,12)|(143,12),(145,12)|(7,13),(11,13)|(126,13),(136,13)|(143,13),(145,13)|(233,13),(234,13)|(242,13),(246,13)|(11,14),(13,14)|(19,14),(21,14)|(113,14),(115,14)|(233,14),(234,14)|(242,14),(246,14)|(11,15),(13,15)|(19,15),(21,15)|(114,15),(115,15)|(4,16),(11,16)|(114,16),(115,16)|(242,16),(245,16)|(4,17),(11,17)|(105,17),(106,17)|(115,17),(119,17)|(132,17),(136,17)|(238,17),(245,17)|(11,18),(12,18)|(105,18),(106,18)|(115,18),(119,18)|(132,18),(136,18)|(11,19),(12,19)|(227,19),(228,19)|(238,19),(246,19)|(7,20),(11,20)|(113,20),(115,20)|(136,20),(137,20)|(227,20),(228,20)|(238,20),(246,20)|(5,21),(7,21)|(5,22),(7,22)|(113,22),(124,22)|(238,22),(245,22)|(10,23),(11,23)|(113,23),(123,23)|(10,24),(11,24)|(136,24),(137,24)|(243,24),(245,24)|(5,25),(7,25)|(37,25),(41,25)|(81,25),(86,25)|(113,25),(115,25)|(138,25),(139,25)|(143,25),(147,25)|(187,25),(194,25)|(5,26),(37,26)|(41,26),(81,26)|(86,26),(115,26)|(136,26),(138,26)|(139,26),(143,26)|(147,26),(187,26)|(194,26),(243,26)|(123,32),(124,32)|
(47,7),(48,8)|
(30,8),(31,7)|
(243.5,16),(243.5,17)|(243.5,22),(243.5,24)|
(7,23.5),(9,10.5)|(10,23.5),(11,23.5)|(12,10.5),(12,18.5)|(13,14.5),(17,18.5)|(18,23.5),(19,14.5)|(21,14.5),(24,14.5)|(32,25.5),(37,25.5)|(41,25.5),(46,25.5)|(58,8.5),(61,8.5)|(66,8.5),(70,8.5)|(78,25.5),(81,25.5)|(86,25.5),(90,25.5)|(100,17.5),(102,8.5)|(105,8.5),(105,17.5)|(106,17.5),(106,22.5)|(109,8.5),(109,12.5)|(113,12.5),(115,8.5)|(136,25.5),(137,21.5)|(138,25.5),(139,25.5)|(143,12.5),(143,25.5)|(145,12.5),(146,21.5)|(147,25.5),(148,17.5)|(151,12.5),(151,25.5)|(154,8.5),(158,8.5)|(164,8.5),(168,8.5)|(183,25.5),(187,25.5)|(194,25.5),(198,25.5)|(213,8.5),(217,8.5)|(222,8.5),(224,19.5)|(226,8.5),(227,19.5)|(228,19.5),(230,13.5)|(233,13.5),(234,13.5)|(235,10.5),(239,10.5)|
end file : SS_E06