Pièce : GW_A07
taille : 54x35
######################################################
######################################################
######################################################
######################################################
######################################################
######################################################
########...###########################################
#######.....##########################################
#####=.......#########################################
#######.......################################.#######
########.......#############################...#######
###########....############################.....######
#########=##....##########################.......=####
############....##########################......######
#############....########################....#########
#############.....#######################....#=#######
#############.....#######################....#########
##############....#######################....#########
##############.....#####################....##########
###############.....####################....##########
###############.....####################....##########
################.....##################.....##########
#################.....################......##########
#################......#############.......###########
##################........#######..........###########
##################........................############
###################......................#############
####################.....................#############
#####################...................##############
######################................################
######################...............#################
########################......########################
#################################=####################
######################################################
######################################################
11,6|7,7|8,7|11,7|12,7|7,8|12,8|13,8|13,9|14,9|46,9|47,9|7,9|14,10|15,10|44,10|46,10|7,10|8,10|43,11|44,11|47,11|48,11|8,11|11,11|15,12|16,12|42,12|43,12|48,12|11,12|12,12|16,14|17,14|41,14|42,14|48,13|12,14|13,14|17,15|18,15|45,14|48,14|13,17|14,17|18,18|19,18|40,18|41,18|19,19|20,19|44,18|45,18|14,19|15,19|20,21|21,21|39,21|40,21|15,21|16,21|21,22|22,22|38,22|39,22|16,22|17,22|22,23|23,23|36,23|38,23|23,24|26,24|33,24|36,24|43,23|44,23|17,24|18,24|26,25|33,25|42,25|43,25|18,26|19,26|41,26|42,26|19,27|20,27|20,28|21,28|40,28|41,28|21,29|22,29|38,29|40,29|37,30|38,30|22,31|24,31|30,31|37,31|24,32|30,32|