Pièce : GW_B04
taille : 54x78
######################################################
######################################################
######################################################
######################################################
######################################################
######################################################
######################################################
#######################.##############################
######################..|.############################
#####################...|..###########################
###################=........##########################
#####################.......##########################
######################.......#########################
######################.......#########################
#######################.......########################
#######################.......#.######################
#######################.......#..#####################
########################......|..#####################
#########################.....|...####################
#######....###############....|...####################
######......###############...|....###################
####=........###############..|.....=########..#######
######.......###############..|...##########....######
#######.......##############..|..########=.......=####
########.......############...|.###########.....######
########........#########.....|.##########......######
#########.........#####|......|##########......#######
###########.........|..|......##########......########
############........|..|.....##########.......########
#############.......|..|....#######..|.......#########
##############......|..|...#######...|.....###########
##############......|..|....####..........############
###############........|......|..........#############
##################.....|......|........###############
##################.....|......|.......################
################.......|......|......#################
#################......|......|.....##################
#################......|......|.....##################
#################......|.....###....##################
#################......|.....#|......#################
##################.....|.....##......#################
###################....|......#.....##################
###################....|......|.....##################
###################....|......|....###################
###################....|......|....###################
####################...|......|....###################
####################..##......|....###################
####################...#......|....###################
###################....|......|.....##################
###################....|......|.....##################
###################....|.....##......#################
###################....|.....##.......################
###################....|......##.......###############
##################............##........##############
##################............|.........##############
##################............|..........#############
#################.............|..........#############
#################........................#############
###############=..........................=###########
#################........................#############
#################........................#############
#################.............|..........#############
#################......#......|.........##############
#################......#......#........###############
##################....##.....##........###############
##################.....|......#.......################
####################...|......|.....##################
########################......|..#####################
##############################H#######################
##########################=#=#########################
######################################################
######################################################
######################################################
######################################################
######################################################
######################################################
######################################################
######################################################
24,7|22,8|23,8|26,8|21,9|22,9|26,9|27,9|21,10|27,10|28,10|21,11|28,12|29,12|21,12|22,12|29,14|30,14|22,14|23,14|31,15|32,15|32,16|33,16|23,17|24,17|33,18|34,18|7,19|11,19|24,18|25,18|6,20|7,20|11,20|12,20|25,19|26,19|34,20|35,20|6,21|12,21|13,21|26,20|27,20|35,21|45,21|47,21|27,21|28,21|44,22|45,22|47,22|48,22|6,22|13,23|14,23|34,22|44,23|48,23|6,23|7,23|14,24|15,24|27,24|28,24|33,23|34,23|7,24|8,24|15,25|16,25|25,25|27,25|32,24|33,24|42,25|43,25|43,24|48,24|16,26|18,26|25,26|41,26|42,26|8,26|9,26|18,27|32,26|40,27|41,27|47,26|48,26|9,27|11,27|39,28|40,28|46,27|47,27|11,28|12,28|29,28|30,28|35,29|39,29|12,29|13,29|28,29|29,29|34,30|35,30|45,29|46,29|13,30|14,30|27,31|27,30|28,31|28,30|32,31|34,31|43,30|45,30|28,32|32,32|42,31|43,31|14,32|15,32|41,32|42,32|15,33|18,33|39,33|41,33|16,35|18,35|38,34|39,34|37,35|38,35|16,36|17,36|36,36|37,36|29,38|32,39|32,38|36,39|37,39|17,40|18,40|29,41|30,41|18,41|19,41|36,41|37,41|35,43|36,43|19,45|20,45|22,47|22,46|23,47|19,48|20,48|35,48|36,48|36,50|37,50|29,50|37,51|38,51|29,52|30,52|38,52|39,52|18,53|19,53|31,52|32,52|39,53|40,53|32,54|40,55|41,55|17,56|18,56|17,58|41,58|17,59|41,59|24,62|23,62|40,62|41,62|39,63|40,63|17,64|18,64|22,65|22,64|23,64|29,65|29,64|30,65|30,64|38,65|39,65|18,66|20,66|36,66|38,66|20,67|33,67|36,67|24,68|33,68|