Pièce : GW_C07
taille : 48x120
################################################
################################################
################################################
################################################
###################################=############
###################################|############
##################################.|..##########
#################################..|..##########
#################################..|..##########
#################################..|..##########
#################################..|..##########
#################################..|..##########
#################################..|..##########
#################################..|..##########
#################################..|..##########
#################################..|..##########
#################################..|..##########
################################...|..##########
################################...|...#########
################################...|...#########
################################...|...#########
#################################..|...#########
#################################..|...#########
#################################..|...#########
#################################..|..##########
##################################.|..##########
##################################.|..##########
##################################.|..##########
##################################.|..##########
##################################.|..##########
##################################.|..##########
##################################.|...#########
##################################.|...#########
#################################..|...#########
#################################..|...#########
#################################..|....########
################################...|....########
################################...|....########
################################...|....########
###############################....|....########
###############################.........########
###############################.........########
###############################.........########
##############################..........########
############################............########
##########....######..###...............########
########................................########
#######.................................########
######..................................########
######..................................########
#####..................................#########
#####.................................##########
#####...............####............############
####...............#########......##############
####...............#############################
####..............###########=#=################
####.............###############################
####...........#################################
#####.........##################################
#####........###################################
#####.......####################################
######......####################################
######........##################################
#######.......##################################
#######.........##############..################
########.............................###########
#########...............................########
#########.................................######
############...............................#####
################...........................#####
###########################................#####
#############################..............#####
################################...........#####
##################################........######
###################################.......######
####################################......######
####################################.....#######
####################################.....#######
###################################.....########
##################################......########
##############################........##########
############################.........###########
##########################...........###########
##########################...........###########
##########################..........############
##########################........##############
########################..........##############
########################......##################
########################.....###.###############
#######################......###.###############
#######################......###.###############
#######################......###.###############
#######################......###.###############
#######################......###.###############
#######################......###.###############
#######################......###.###############
########################.....###.###############
########################......##.###############
########################......##.###############
########################......##.###############
########################......##.###############
#######################...........=#############
#####################.........##################
###################..........###################
################.............###################
#####.......................####################
####.......................#####################
###......................#######################
###..................###########################
####..............##############################
#####.....######################################
################################################
#######=########################################
################################################
################################################
################################################
################################################
################################################
################################################
################################################
(3,107),(3,109)|(4,53),(4,58)|(4,106),(4,107)|(4,109),(4,110)|(5,50),(5,53)|(5,58),(5,61)|(5,105),(5,106)|(5,110),(5,111)|(6,48),(6,50)|(6,61),(6,63)|(7,47),(7,48)|(7,63),(7,65)|(7,112),(7,113)|(8,46),(8,47)|(8,65),(8,66)|(8,112),(8,113)|(9,66),(9,68)|(10,45),(10,46)|(10,110),(10,111)|(12,60),(12,62)|(12,68),(12,69)|(13,59),(13,60)|(14,45),(14,46)|(14,58),(14,59)|(14,62),(14,64)|(15,57),(15,58)|(16,64),(16,65)|(16,69),(16,70)|(16,104),(16,105)|(17,56),(17,57)|(18,55),(18,56)|(18,109),(18,110)|(19,53),(19,55)|(19,103),(19,104)|(20,45),(20,46)|(20,52),(20,53)|(21,102),(21,103)|(21,108),(21,109)|(22,45),(22,46)|(23,89),(23,96)|(23,101),(23,102)|(24,52),(24,53)|(24,86),(24,89)|(24,96),(24,101)|(25,45),(25,46)|(25,107),(25,108)|(26,82),(26,86)|(27,70),(27,71)|(27,106),(27,107)|(28,44),(28,45)|(28,53),(28,54)|(28,81),(28,82)|(28,105),(28,106)|(29,55),(29,56)|(29,71),(29,72)|(29,88),(29,97)|(29,103),(29,105)|(30,43),(30,44)|(30,55),(30,56)|(30,64),(30,65)|(30,80),(30,81)|(30,87),(30,88)|(30,97),(30,101)|(30,102),(30,103)|(31,39),(31,43)|(31,55),(31,56)|(32,17),(32,21)|(32,36),(32,39)|(32,55),(32,56)|(32,64),(32,65)|(32,72),(32,73)|(32,88),(32,101)|(33,7),(33,17)|(33,21),(33,25)|(33,33),(33,36)|(33,88),(33,101)|(34,6),(34,7)|(34,25),(34,33)|(34,53),(34,54)|(34,73),(34,74)|(34,79),(34,80)|(34,85),(34,87)|(35,4),(35,74)|(35,75),(35,78)|(35,79),(35,101)|(35,102),(36,4)|(36,52),(36,53)|(36,75),(36,78)|(36,84),(36,85)|(37,65),(37,66)|(37,81),(37,84)|(38,6),(38,18)|(38,24),(38,31)|(38,51),(38,52)|(38,80),(38,81)|(39,18),(39,24)|(39,31),(39,35)|(39,50),(39,51)|(40,35),(40,50)|(40,66),(40,67)|(40,78),(40,80)|(41,76),(41,78)|(42,67),(42,68)|(42,73),(42,76)|(43,68),(43,73)|
(35,4),(36,4)|(34,6),(38,6)|(33,7),(34,7)|(32,17),(33,17)|(38,18),(39,18)|(32,21),(33,21)|(38,24),(39,24)|(33,25),(34,25)|(38,31),(39,31)|(33,33),(34,33)|(39,35),(40,35)|(32,36),(33,36)|(31,39),(32,39)|(30,43),(31,43)|(28,44),(30,44)|(10,45),(14,45)|(20,45),(22,45)|(25,45),(28,45)|(8,46),(10,46)|(14,46),(20,46)|(22,46),(25,46)|(7,47),(8,47)|(6,48),(7,48)|(5,50),(6,50)|(39,50),(40,50)|(38,51),(39,51)|(20,52),(24,52)|(36,52),(38,52)|(4,53),(5,53)|(19,53),(20,53)|(24,53),(28,53)|(34,53),(36,53)|(28,54),(34,54)|(18,55),(19,55)|(29,55),(30,55)|(31,55),(32,55)|(17,56),(18,56)|(29,56),(30,56)|(31,56),(32,56)|(15,57),(17,57)|(4,58),(5,58)|(14,58),(15,58)|(13,59),(14,59)|(12,60),(13,60)|(5,61),(6,61)|(12,62),(14,62)|(6,63),(7,63)|(14,64),(16,64)|(30,64),(32,64)|(7,65),(8,65)|(16,65),(30,65)|(32,65),(37,65)|(8,66),(9,66)|(37,66),(40,66)|(40,67),(42,67)|(9,68),(12,68)|(42,68),(43,68)|(12,69),(16,69)|(16,70),(27,70)|(27,71),(29,71)|(29,72),(32,72)|(32,73),(34,73)|(42,73),(43,73)|(34,74),(35,74)|(35,75),(36,75)|(41,76),(42,76)|(35,78),(36,78)|(40,78),(41,78)|(34,79),(35,79)|(30,80),(34,80)|(38,80),(40,80)|(28,81),(30,81)|(37,81),(38,81)|(26,82),(28,82)|(36,84),(37,84)|(34,85),(36,85)|(24,86),(26,86)|(30,87),(34,87)|(29,88),(30,88)|(32,88),(33,88)|(23,89),(24,89)|(23,96),(24,96)|(29,97),(30,97)|(23,101),(24,101)|(30,101),(32,101)|(33,101),(35,101)|(21,102),(23,102)|(30,102),(35,102)|(19,103),(21,103)|(29,103),(30,103)|(16,104),(19,104)|(5,105),(16,105)|(28,105),(29,105)|(4,106),(5,106)|(27,106),(28,106)|(3,107),(4,107)|(25,107),(27,107)|(21,108),(25,108)|(3,109),(4,109)|(18,109),(21,109)|(4,110),(5,110)|(10,110),(18,110)|(5,111),(10,111)|(7,112),(8,112)|(7,113),(8,113)|