Pièce : GW_C08
taille : 152x35
########################################################################################################################################################
########################################################################################################################################################
########################################################################################################################################################
#######################################################################################################################################......###########
##################################################################################################################################............=#########
###############################################################################.........#######################################..............###########
###########################################################################...................############################..................############
#####=###########################################################..............................#########...................................#############
#####|###########################################################...............................###.......................................##############
####.|....######################################################......................................................................#.################
###..|......################################..............####......................................................................####################
###..|........###################...............................................|........................#####################..########################
#####|.............######.......................................................|.....................##################################################
########...............................................................|........|..................#####################################################
###########............................................................#........|...............####=###################################################
##############........................................#########.......###.......#......##......#########################################################
################..........................######################......##.......###......#......#########################################################
#####################...............############=#=#############.......#.......###......#.......#####.................##################################
##############################################################.........|........#.......|................................###############################
#############################################################..........|........#.......|.......................................########################
###########################################################............|........|.......|..............................................#################
##########################################################.............|........|.......|...............................................################
#########################################################..............|........|.......|.........................#####..................###############
########################################################...............|........|.......|..............#######################...........###############
########################################################...............|........|.......|............####=#######################.......################
######################################################=................|........|.......|...........####################################################
########################################################...............|........|.......|..........##################################=##################
########################################################...............|........|.......|.........######################################################
#########################################################..............|........|.......|.........######################################################
##########################################################.............|........#.......|.......########################################################
#############################################################..........#.......##.......#......#########################################################
####################################################################.####.....#####...##################################################################
#################################################################=######################################################################################
###########################################################################=########=###################################################################
########################################################################################################################################################
141,3|130,4|135,4|141,4|79,5|88,5|127,5|130,5|75,6|79,6|88,6|94,6|122,6|127,6|141,5|65,7|75,7|94,7|95,7|104,7|122,7|140,6|141,6|95,8|96,8|99,8|104,8|139,7|140,7|4,9|10,9|64,9|65,9|96,9|99,9|138,8|139,8|3,10|4,10|10,10|12,10|44,10|58,10|62,10|64,10|135,9|134,9|136,9|138,9|12,11|14,11|33,11|44,11|58,11|62,11|132,10|135,10|134,10|136,10|14,12|19,12|25,12|33,12|105,11|126,11|128,11|132,11|3,12|19,13|25,13|102,12|105,12|126,12|128,12|8,13|99,13|102,13|8,14|11,14|96,14|99,14|11,15|14,15|54,15|63,15|70,15|72,16|72,15|71,15|73,16|73,15|87,16|87,15|88,16|89,15|95,15|96,15|14,16|16,16|42,16|54,16|63,16|64,16|70,17|71,17|79,16|81,16|80,16|82,16|95,17|96,17|101,17|118,17|16,17|21,17|36,17|42,17|62,18|64,18|79,18|81,18|80,18|82,18|96,18|101,18|118,18|121,18|21,18|36,18|61,19|62,19|121,19|128,19|59,20|61,20|128,20|135,20|58,21|59,21|135,21|136,21|57,22|58,22|136,22|137,22|56,23|57,23|114,22|119,22|103,23|114,23|119,23|126,23|56,25|101,24|103,24|126,24|129,24|136,24|137,24|100,25|101,25|129,25|136,25|56,26|99,26|100,26|98,27|99,27|56,28|57,28|57,29|58,29|96,29|98,29|58,30|61,30|79,30|80,30|95,30|96,30|61,31|68,31|69,31|72,31|71,31|73,31|78,31|79,31|81,31|83,31|86,31|89,31|88,31|95,31|68,32|69,32|73,32|78,32|83,32|86,32|