Pièce : GW_C10
taille : 158x35
##############################################################################################################################################################
##############################################################################################################################################################
##############################################################################################################################################################
##############################################################################################################################################################
##############################################################################################################################################################
######################################################################.......#################################################################################
################################################################...................#####...........####################.|.####################################
##########################################################..........................###..............################...|......###############################
#######################################################.............................###...............#############.....|.......##############################
#####################################################................................##...............###....######.....|.......|.############################
##################################################...................................#.................#.....####.......|.......|..###########################
###############################################........................................................#......##.......####.....|.....########################
###################################################....................................................#......##.....--####-----#-----########################
###################################################...........................................................#.........|.......|......#######################
########################################.........##.....................................................................|...............######################
#####################################............#..........................|........................................................#########################
###############################.............................................|........................................................#########################
############################....................................|..........##........................................................##....###################
##################..............................................|...........#...............|.........................................#......#################
#########.......................................................|...........#...............|.................................................################
########........................................................|...........#...............#...................................................##############
#######.........................................................|...........##..............#.......................................................##########
#####=..........................................................|...........|...............#........................................................#########
########......................................................###...........|...............|.........................................................=#######
##########..................................................######..........|...............|.......................................................##########
###############..........######..........................##########.........|...............|.....#####............................................###########
###############################.........................############........|...............|...####=#####..................................##################
##################################....................###############.......|..............###################...........................#####=###############
####################################..............#####################.....|..........##################################..........###########################
########################################......############################..|.......##########################################################################
############################################################################H#################################################################################
#########################################=##=#################################=###############################################################################
##############################################################################################################################################################
##############################################################################################################################################################
##############################################################################################################################################################
(5,22),(5,23)|(7,21),(7,22)|(8,20),(8,21)|(8,23),(8,24)|(9,19),(9,20)|(10,24),(10,25)|(15,25),(15,26)|(18,18),(18,19)|(25,25),(25,26)|(28,17),(28,18)|(31,16),(31,17)|(31,25),(31,27)|(34,27),(34,28)|(36,28),(36,29)|(37,15),(37,16)|(40,14),(40,15)|(40,29),(40,30)|(41,31),(41,32)|(42,31),(42,32)|(44,31),(44,32)|(45,31),(45,32)|(46,29),(46,30)|(47,11),(47,12)|(49,14),(49,16)|(50,10),(50,11)|(50,15),(50,16)|(50,28),(50,29)|(51,12),(51,15)|(53,9),(53,10)|(54,27),(54,28)|(55,8),(55,9)|(56,26),(56,27)|(57,25),(57,26)|(58,7),(58,8)|(60,24),(60,25)|(62,23),(62,24)|(64,6),(64,7)|(65,23),(65,24)|(66,24),(66,25)|(67,25),(67,26)|(68,26),(68,27)|(69,27),(69,28)|(70,5),(70,6)|(71,28),(71,29)|(74,29),(74,30)|(75,17),(75,18)|(76,18),(76,22)|(76,30),(76,31)|(77,5),(77,6)|(77,17),(77,21)|(77,30),(77,31)|(78,21),(78,22)|(78,31),(78,32)|(79,31),(79,32)|(83,6),(83,7)|(84,7),(84,9)|(84,29),(84,30)|(85,9),(85,11)|(86,10),(86,11)|(87,7),(87,10)|(87,28),(87,29)|(88,6),(88,7)|(91,27),(91,28)|(92,20),(92,23)|(93,20),(93,23)|(96,26),(96,27)|(98,25),(98,26)|(99,6),(99,7)|(100,26),(100,27)|(101,7),(101,8)|(101,26),(101,27)|(102,8),(102,10)|(103,10),(103,13)|(103,25),(103,26)|(104,10),(104,13)|(105,9),(105,10)|(106,26),(106,27)|(109,9),(109,11)|(110,11),(110,14)|(110,27),(110,28)|(111,13),(111,14)|(112,11),(112,13)|(113,10),(113,11)|(115,8),(115,10)|(117,7),(117,8)|(119,6),(119,7)|(119,11),(119,13)|(121,28),(121,29)|(122,6),(122,7)|(123,11),(123,13)|(127,7),(127,8)|(128,8),(128,9)|(128,12),(128,13)|(129,12),(129,13)|(130,9),(130,10)|(131,10),(131,11)|(131,28),(131,29)|(133,15),(133,18)|(134,11),(134,13)|(134,18),(134,19)|(135,13),(135,14)|(135,17),(135,19)|(136,14),(136,15)|(137,27),(137,28)|(139,17),(139,18)|(140,26),(140,27)|(141,18),(141,19)|(142,19),(142,20)|(142,27),(142,28)|(143,27),(143,28)|(144,20),(144,21)|(147,25),(147,26)|(148,21),(148,22)|(148,24),(148,25)|(149,22),(149,23)|(151,23),(151,24)|
(70,70),(77,5)|(64,64),(70,6)|(77,77),(83,6)|(88,88),(99,6)|(119,119),(122,6)|(58,58),(64,7)|(83,83),(84,7)|(87,87),(88,7)|(99,99),(101,7)|(117,117),(119,7)|(122,122),(127,7)|(55,55),(58,8)|(101,101),(102,8)|(115,115),(117,8)|(127,127),(128,8)|(53,53),(55,9)|(84,84),(85,9)|(105,105),(109,9)|(128,128),(130,9)|(50,50),(53,10)|(86,86),(87,10)|(102,102),(103,10)|(104,104),(105,10)|(113,113),(115,10)|(130,130),(131,10)|(47,47),(50,11)|(85,85),(86,11)|(109,109),(110,11)|(112,112),(113,11)|(119,119),(123,11)|(131,131),(134,11)|(47,47),(51,12)|(128,128),(129,12)|(103,103),(104,13)|(111,111),(112,13)|(119,119),(123,13)|(128,128),(129,13)|(134,134),(135,13)|(40,40),(49,14)|(110,110),(111,14)|(135,135),(136,14)|(37,37),(40,15)|(50,50),(51,15)|(133,133),(136,15)|(31,31),(37,16)|(49,49),(50,16)|(28,28),(31,17)|(75,75),(77,17)|(135,135),(139,17)|(18,18),(28,18)|(75,75),(76,18)|(133,133),(134,18)|(139,139),(141,18)|(9,9),(18,19)|(134,134),(135,19)|(141,141),(142,19)|(8,8),(9,20)|(92,92),(93,20)|(142,142),(144,20)|(7,7),(8,21)|(77,77),(78,21)|(144,144),(148,21)|(5,5),(7,22)|(76,76),(78,22)|(148,148),(149,22)|(5,5),(8,23)|(62,62),(65,23)|(92,92),(93,23)|(149,149),(151,23)|(8,8),(10,24)|(60,60),(62,24)|(65,65),(66,24)|(148,148),(151,24)|(10,10),(15,25)|(25,25),(31,25)|(57,57),(60,25)|(66,66),(67,25)|(98,98),(103,25)|(147,147),(148,25)|(15,15),(25,26)|(56,56),(57,26)|(67,67),(68,26)|(96,96),(98,26)|(100,100),(101,26)|(103,103),(106,26)|(140,140),(147,26)|(31,31),(34,27)|(54,54),(56,27)|(68,68),(69,27)|(91,91),(96,27)|(100,100),(101,27)|(106,106),(110,27)|(137,137),(140,27)|(142,142),(143,27)|(34,34),(36,28)|(50,50),(54,28)|(69,69),(71,28)|(87,87),(91,28)|(110,110),(121,28)|(131,131),(137,28)|(142,142),(143,28)|(36,36),(40,29)|(46,46),(50,29)|(71,71),(74,29)|(84,84),(87,29)|(121,121),(131,29)|(40,40),(46,30)|(74,74),(76,30)|(77,77),(84,30)|(41,41),(42,31)|(44,44),(45,31)|(76,76),(77,31)|(78,78),(79,31)|(41,41),(42,32)|(44,44),(45,32)|(78,78),(79,32)|


(64.5,17),(64.5,23)|(76.5,15),(76.5,17)|(76.5,22),(76.5,30)|(92.5,18),(92.5,20)|(92.5,23),(92.5,27)|(120.5,6),(120.5,11)|(120.5,13),(120.5,15)|(128.5,9),(128.5,12)|(128.5,13),(128.5,14)|
(117,12.5),(119,12.5)|(123,12.5),(128,12.5)|(129,12.5),(134,12.5)|
end file : GW_C10