Piece : SI_B03
54x78
-1222x-216
.......................########.......................
.......................########.......................
.......................########.......................
.......................########.......................
.......................########.......................
.......................######=----....................
.......................########.......................
.......................########.......................
...............#####...########....####...............
.............--#-#-#---######------####--.............
...............#####...########....####...............
...............#####...########.....##................
...............#####...########.......................
.......................########.......................
.......................########.......................
.......................########.......................
.......................########.......................
.......................########.......................
.......................########.......................
.......................########.......................
.......................#=######.......................
.......................#|######.......................
........................|....|........................
........................|....|........................
........................|....|........................
.....#####...................|..............#####.....
.....###=#...................|..............#=#=#.....
.....#####...................|..............#####.....
.....#####...................|..............#####.....
.....#####...................|..............#####.....
......|.|...............|....|...............|.|......
......|.|...............|....|...............|........
........|.............##########.............|........
........|.............##=####=##......................
......................##########......................
.......................########.......................
.......................########.......................
.......................########......................#
.......................########.......................
.......................########.......................
.......................########.......................
.......................########.......................
.......................########.......................
.......................########.......................
.......................#=####=#.......................
.......................#|####|#.......................
........................|....|........................
........................|....|........................
........................|....|........................
........................|....|........................
.............................|........................
.............................|........................
.............................|........................
.............................|........................
........................|....|........................
........................|....|........................
......................-#H####H#..................#####
.......................#=####=#.................######
.......................########.................######
......................-##########...............######
.......................##########...............######
.......................##########-...............=####
......................-##########...............######
.......................##########................=####
.......................##########-..............######
..../#####............-##########.........../#########
.../###=##.............##########........../##########
...#######.............##########-.........###########
...#######.............##########..........###########
...#######...........############..........###########
...#######...........############..........###########
...#######...........##########............###########
...#######...........##########............###########
...#######...........##########............###########
...#######...........##########............###########
...#######...........##########............###########
...#######...........##########............###########
...#######...........##########............###########
(3,67),(3,78)|(5,25),(5,30)|(7,66),(7,67)|(8,26),(8,27)|(8,66),(8,67)|(9,26),(9,27)|(10,25),(10,30)|(10,65),(10,78)|(15,8),(15,13)|(16,9),(16,10)|(17,9),(17,10)|(18,9),(18,10)|(19,9),(19,10)|(20,8),(20,13)|(21,69),(21,78)|(22,32),(22,35)|(23,0),(23,22)|(23,35),(23,46)|(23,56),(23,69)|(24,20),(24,22)|(24,33),(24,34)|(24,44),(24,46)|(24,56),(24,58)|(25,20),(25,22)|(25,33),(25,34)|(25,44),(25,46)|(25,56),(25,58)|(29,5),(29,6)|(29,9),(29,10)|(29,33),(29,34)|(29,44),(29,46)|(29,56),(29,58)|(30,33),(30,34)|(30,44),(30,46)|(30,56),(30,58)|(31,0),(31,5)|(31,6),(31,9)|(31,10),(31,22)|(31,35),(31,46)|(31,56),(31,59)|(31,71),(31,78)|(32,32),(32,35)|(33,59),(33,71)|(35,8),(35,11)|(36,11),(36,12)|(38,11),(38,12)|(39,8),(39,11)|(43,67),(43,78)|(44,25),(44,30)|(45,26),(45,27)|(46,26),(46,27)|(47,26),(47,27)|(48,26),(48,27)|(48,57),(48,61)|(48,62),(48,63)|(48,64),(48,65)|(49,25),(49,30)|(49,56),(49,57)|(50,61),(50,62)|(50,63),(50,64)|(53,37),(53,38)|(54,37),(54,38)|
(23,0),(31,0)|(29,5),(31,5)|(29,6),(31,6)|(15,8),(20,8)|(35,8),(39,8)|(16,9),(17,9)|(18,9),(19,9)|(29,9),(31,9)|(16,10),(17,10)|(18,10),(19,10)|(29,10),(31,10)|(35,11),(36,11)|(38,11),(39,11)|(36,12),(38,12)|(15,13),(20,13)|(24,20),(25,20)|(23,22),(24,22)|(25,22),(31,22)|(5,25),(10,25)|(44,25),(49,25)|(8,26),(9,26)|(45,26),(46,26)|(47,26),(48,26)|(8,27),(9,27)|(45,27),(46,27)|(47,27),(48,27)|(5,30),(10,30)|(44,30),(49,30)|(22,32),(32,32)|(24,33),(25,33)|(29,33),(30,33)|(24,34),(25,34)|(29,34),(30,34)|(22,35),(23,35)|(31,35),(32,35)|(53,37),(54,37)|(53,38),(54,38)|(24,44),(25,44)|(29,44),(30,44)|(23,46),(24,46)|(25,46),(29,46)|(30,46),(31,46)|(23,56),(24,56)|(25,56),(29,56)|(30,56),(31,56)|(49,56),(54,56)|(48,57),(49,57)|(24,58),(25,58)|(29,58),(30,58)|(31,59),(33,59)|(48,61),(50,61)|(48,62),(50,62)|(48,63),(50,63)|(48,64),(50,64)|(5,65),(10,65)|(45,65),(48,65)|(7,66),(8,66)|(7,67),(8,67)|(21,69),(23,69)|(31,71),(33,71)|(3,78),(10,78)|(21,78),(31,78)|
None|
(3,67),(5,65)|(43,67),(45,65)|
(6.5,30),(6.5,32)|(8.5,30),(8.5,34)|(24.5,21),(24.5,25)|(24.5,30),(24.5,32)|(24.5,45),(24.5,50)|(24.5,54),(24.5,56)|(29.5,22),(29.5,32)|(29.5,45),(29.5,56)|(45.5,30),(45.5,33)|(47.5,30),(47.5,31)|
(30,5.5),(34,5.5)|(13,9.5),(15,9.5)|(16,9.5),(17,9.5)|(18,9.5),(19,9.5)|(20,9.5),(23,9.5)|(29,9.5),(35,9.5)|(39,9.5),(41,9.5)|(22,56.5),(23,56.5)|(22,59.5),(23,59.5)|(33,61.5),(34,61.5)|(22,62.5),(23,62.5)|(33,64.5),(34,64.5)|(22,65.5),(23,65.5)|(33,67.5),(34,67.5)|
end file : SI_B03