Pièce : SI_B11
taille : 48x78
................................................
................................................
................................................
................................................
................................................
................................................
................................|...............
................................|...............
................................|...............
................................#...............
................................|...............
................................|...............
................................|...............
................................|...............
................................|...............
................................|...............
................................|...............
................................|...............
.........................##.....|............##.
.........................##.....|............##.
.........................##../############/..##.
.........................##..##############..##.
.........................##..##############..##.
.........................##..##############..##.
.........................##..##############..##.
.........................##--##############--##.
.........................##..##############..##.
.........................##--##############--##.
.........................##..##############..##.
.........................##....|...|...|.....##.
...............................|..##...##.......
...............................#..##...|........
...............................|...|...|........
...............................#...#............
.......................###.....#...|............
.......................#=#.........#............
.......................###.........|............
.......................###......................
................................................
................................................
|...............................................
|..............................................|
|..............................................|
|.............|................................|
|.............|................................#
#.............|..|.............................#
#.............|..|.............................#
#.............####.............................#
#............./##/.............................#
#.............|##|.....................|.......#
#.............|..|.....................|.......#
#.............|..|..................|..|.......#
#.............|..|..................####.......#
#.............+--+................../##/.......#
#.............|..|..................|##|.......#
#.............|..|..................|..|.......#
#.............|..|..................|..|.......#
#.......|.....|..|..................|..|.......#
#.......|.....####..................|..|.......#
#....|..|...../##/..................+--+.......#
#....|..|.....|##|..................|..|.......#
#....####.....|..|..................|..|.......#
#..../##/.....|..|..................|..|.......#
#....|##|.....|..|..................####.......#
###..|..|.....|..|...#######......../##/......##
###..|..|.....|..|...#######........|##|.....###
####.|..|.....|..|...#######........|..|...#####
#######.|.....|..|....=#####........|..|....=###
#######.|.....|..|...#########......|..|...#####
################################################
###########=####################=###############
################################################
################################################
################################################
################################################
################################################
################################################
################################################
(1,45),(1,64)|(3,64),(3,66)|(4,66),(4,67)|(7,67),(7,69)|(11,70),(11,71)|(12,70),(12,71)|(14,47),(14,58)|(15,50),(15,61)|(17,50),(17,61)|(18,47),(18,58)|(21,64),(21,67)|(21,68),(21,69)|(23,34),(23,38)|(23,67),(23,68)|(24,35),(24,36)|(25,18),(25,30)|(25,35),(25,36)|(26,34),(26,38)|(27,18),(27,30)|(28,64),(28,68)|(30,20),(30,68)|(31,31),(31,32)|(31,33),(31,35)|(32,9),(32,10)|(32,31),(32,32)|(32,33),(32,35)|(32,70),(32,71)|(33,9),(33,10)|(33,70),(33,71)|(34,30),(34,32)|(35,33),(35,34)|(35,35),(35,36)|(36,30),(36,32)|(36,33),(36,34)|(36,35),(36,36)|(36,52),(36,63)|(37,55),(37,66)|(39,30),(39,31)|(39,55),(39,66)|(40,52),(40,63)|(41,30),(41,31)|(43,29),(43,66)|(43,67),(43,68)|(45,18),(45,30)|(45,65),(45,66)|(45,67),(45,68)|(46,64),(46,65)|(47,18),(47,30)|(47,44),(47,64)|
(32,9),(33,9)|(32,10),(33,10)|(25,18),(27,18)|(45,18),(47,18)|(30,20),(42,20)|(29,29),(43,29)|(25,30),(27,30)|(34,30),(36,30)|(39,30),(41,30)|(45,30),(47,30)|(31,31),(32,31)|(39,31),(41,31)|(31,32),(32,32)|(34,32),(36,32)|(31,33),(32,33)|(35,33),(36,33)|(23,34),(26,34)|(35,34),(36,34)|(24,35),(25,35)|(31,35),(32,35)|(35,35),(36,35)|(24,36),(25,36)|(35,36),(36,36)|(23,38),(26,38)|(47,44),(48,44)|(0,45),(1,45)|(14,47),(18,47)|(15,50),(17,50)|(36,52),(40,52)|(37,55),(39,55)|(14,58),(18,58)|(5,61),(9,61)|(15,61),(17,61)|(36,63),(40,63)|(1,64),(3,64)|(6,64),(8,64)|(21,64),(28,64)|(46,64),(47,64)|(45,65),(46,65)|(3,66),(4,66)|(37,66),(39,66)|(43,66),(45,66)|(4,67),(7,67)|(21,67),(23,67)|(43,67),(45,67)|(21,68),(23,68)|(28,68),(30,68)|(43,68),(45,68)|(7,69),(21,69)|(30,69),(43,69)|(11,70),(12,70)|(32,70),(33,70)|(11,71),(12,71)|(32,71),(33,71)|
(5,62),(6,63)|(14,48),(15,49)|(14,59),(15,60)|(36,53),(37,54)|(36,64),(37,65)|(42,20),(43,21)|
(8,63),(9,62)|(17,49),(18,48)|(17,60),(18,59)|(29,21),(30,20)|(39,54),(40,53)|(39,65),(40,64)|
(0.5,40),(0.5,45)|(5.5,59),(5.5,61)|(5.5,63),(5.5,67)|(8.5,57),(8.5,61)|(8.5,63),(8.5,69)|(14.5,43),(14.5,47)|(14.5,49),(14.5,58)|(14.5,60),(14.5,69)|(17.5,45),(17.5,47)|(17.5,49),(17.5,58)|(17.5,60),(17.5,69)|(31.5,29),(31.5,31)|(31.5,32),(31.5,33)|(32.5,6),(32.5,9)|(32.5,10),(32.5,20)|(35.5,29),(35.5,30)|(35.5,32),(35.5,33)|(35.5,34),(35.5,35)|(35.5,36),(35.5,37)|(36.5,51),(36.5,52)|(36.5,54),(36.5,63)|(36.5,65),(36.5,69)|(39.5,29),(39.5,30)|(39.5,31),(39.5,33)|(39.5,49),(39.5,52)|(39.5,54),(39.5,63)|(39.5,65),(39.5,69)|(47.5,41),(47.5,44)|
(27,25.5),(27,27.5)|(29,25.5),(29,27.5)|(43,25.5),(43,27.5)|(45,25.5),(45,27.5)|
end file : SI_B11