Piece : SI_B10
54x78
495x-40
######################################################
######################################################
######################################################
##################/..............###|#################
#################/..................|...##############
################/...................|...##############
################....................|...##############
################....................|...##############
################....................|...##############
################....................|.......##########
################...................###..###.##########
################.................##########.##########
################.................##########.##########
################.................##########.##########
################.................##########.##########
################.................##########.##########
################.................##########.##########
################.................##########.##########
################.................##########.##########
################................###########.##########
################................###########.##########
################.................##########.##########
################............................##########
################.................##########.##########
#################...............###########.##########
#################................##########.##########
################.................##########.##########
#######..................................##.##########
#####=...........................#######.##.##########
################..#####......#...#######.##.##########
########################################.##.##########
########################################.##.##########
########################################.##.##########
########################################.##.##########
########################################.##.##########
########################################.##.##########
########################################.##.##########
########################################.##.##########
########################################.##.##########
########################################.##.##########
########################################.##.##########
########################################.##.##########
########################################.##.##########
########################################+##+##########
######################################..|..|..########
######################################..|..|..########
######################################..|..|..########
######################################..|..|..########
######################################..|..|..########
######################################..|..|..########
######################################..|..|..########
######################################..|..|..########
######################################.....|..########
######################################.....|..########
######################################.....|..########
##################.........................|..########
##################.........................|..########
##################........................############
##########................................############
##########.................................|.#########
########=..................................|##########
##########............................###..###########
########=.................############################
##########................############################
##########................############################
###########...............############################
############............#######...........############
######################################################
######################################################
######################################################
######################################################
######################################################
######################################################
######################################################
######################################################
######################################################
######################################################
######################################################
(5,28),(5,29)|(7,27),(7,28)|(8,60),(8,61)|(8,62),(8,63)|(10,58),(10,60)|(10,61),(10,62)|(10,63),(10,65)|(11,65),(11,66)|(12,66),(12,67)|(16,24),(16,26)|(16,27),(16,29)|(17,24),(17,26)|(18,29),(18,30)|(18,55),(18,58)|(23,29),(23,30)|(24,66),(24,67)|(26,62),(26,66)|(29,29),(29,30)|(30,29),(30,30)|(31,66),(31,67)|(32,19),(32,21)|(32,24),(32,25)|(33,3),(33,4)|(33,11),(33,19)|(33,21),(33,22)|(33,23),(33,24)|(33,25),(33,27)|(33,28),(33,30)|(35,10),(35,11)|(36,3),(36,4)|(37,3),(37,4)|(38,10),(38,11)|(38,44),(38,55)|(38,61),(38,62)|(40,4),(40,9)|(40,10),(40,11)|(40,28),(40,44)|(41,27),(41,44)|(41,61),(41,62)|(42,57),(42,59)|(42,66),(42,67)|(43,10),(43,22)|(43,23),(43,44)|(43,61),(43,62)|(44,9),(44,44)|(44,60),(44,61)|(45,59),(45,60)|(46,44),(46,57)|
(33,3),(36,3)|(33,4),(36,4)|(37,4),(40,4)|(40,9),(44,9)|(35,10),(38,10)|(40,10),(43,10)|(33,11),(35,11)|(38,11),(40,11)|(32,19),(33,19)|(32,21),(33,21)|(33,22),(43,22)|(33,23),(43,23)|(16,24),(17,24)|(32,24),(33,24)|(32,25),(33,25)|(16,26),(17,26)|(7,27),(16,27)|(33,27),(41,27)|(5,28),(7,28)|(33,28),(40,28)|(5,29),(16,29)|(18,29),(23,29)|(29,29),(30,29)|(16,30),(18,30)|(23,30),(29,30)|(30,30),(33,30)|(38,44),(40,44)|(41,44),(43,44)|(44,44),(46,44)|(18,55),(38,55)|(42,57),(46,57)|(10,58),(18,58)|(42,59),(45,59)|(8,60),(10,60)|(44,60),(45,60)|(8,61),(10,61)|(38,61),(41,61)|(43,61),(44,61)|(8,62),(10,62)|(26,62),(38,62)|(41,62),(43,62)|(8,63),(10,63)|(10,65),(11,65)|(11,66),(12,66)|(24,66),(26,66)|(31,66),(42,66)|(12,67),(24,67)|(31,67),(42,67)|
None|
(16,6),(19,3)|
(36.5,3),(36.5,10)|(40.5,43),(40.5,52)|(43.5,43),(43.5,57)|(43.5,59),(43.5,61)|
(40,43.5),(41,43.5)|(43,43.5),(44,43.5)|
end file : SI_B10