Piece : CC_A12
48x35
-904x-605
################################################
################################################
################################################
################################################
################################################
################################################
################################################
################################################
################################################
################################################
################################################
################################################
################################################
##############/......../########################
#############.................##################
###########=..................##...#############
#############.....##................=###########
###############...##.##............#############
##########################/....../##############
################################################
################################################
################################################
################################################
################################################
################################################
################################################
################################################
################################################
################################################
################################################
################################################
################################################
################################################
################################################
################################################
(11,15),(11,16)|(13,14),(13,15)|(13,16),(13,17)|(15,13),(15,17)|(18,16),(18,18)|(20,16),(20,18)|(21,17),(21,18)|(23,13),(23,17)|(30,14),(30,16)|(32,15),(32,16)|(35,15),(35,16)|(35,17),(35,18)|(37,16),(37,17)|
(15,13),(23,13)|(13,14),(14,14)|(24,14),(30,14)|(11,15),(13,15)|(32,15),(35,15)|(11,16),(13,16)|(18,16),(20,16)|(30,16),(32,16)|(35,16),(37,16)|(13,17),(15,17)|(21,17),(23,17)|(35,17),(37,17)|(15,18),(18,18)|(20,18),(21,18)|(23,18),(26,18)|(34,18),(35,18)|(26.5,19),(27,19)|
(23,13),(24,14)|(26,18),(27,19)|
(14,14),(15,13)|(33,19),(34,18)|
None|
None|
end file : CC_A12