Pièce : CC_B04
taille : 48x80
................................................
............................#...................
............................#...................
............................##..................
............................##/.................
.........................#..###/................
.........................#..####................
.........................#..####-...............
.........................#..####................
.........................#..####-...............
..................#......#..####................
.............###..#......#..####................
.............###..#......#..####................
........########..#.#################...........
..................#.....#############...........
..................#.....#############...........
........########..#.#################...........
..................#..#...#..####................
..................#..#...#..####................
..................#..#...#..####................
................/####H###H######................
.............../################................
.....#.........################/............#...
.....#.....###.###############...###........#...
.....#.....###################.######.......#...
.....#..################################....#...
.....#..........################............#...
.....#..........################............#...
.....#..################################....#...
.....#..........################............#...
.....#..........################............#...
....##----------################............#...
....##..........################..........##H#..
.....#..........################...........###..
.............####################----------###..
.........#...###################................
.........#...###################................
.........#......################................
.........#......################................
.........#......################................
.........#......################.......#........
.........#......################.......#........
.........#.####.###################....#........
...#.....#.####.###################....#........
...#...##################################.......
...#............################................
...#............################............#...
...#...###################################..#...
...#.....#......################.......#....#...
...#.....#......################.......#....#...
...#.....#......################.......#....#...
...#.....#......################.......#....#...
.--+-----+-----#################.......#...#H#..
...#.....#......################.......#...###..
...#.....#......#################------+---###..
..#H#....#......################.......#........
..###....#...###################.......#........
..###....#...###################.......#........
.........#...###################.......#........
.........#......###################....#........
.........#......###################....#........
.........#......###################....#........
.........#......################.......#........
.........#......################.......#........
.........#.....#################.......#........
.....#...#....###################......#........
...####..#...#######################...#........
.############################################...
.############################################...
.####..#####....##########################......
.####..###################################......
..........#########################.....##......
..............#####################.............
..............#####################.............
..............#####################.............
..............#####################.............
..............#####################.............
..............#####################.............
..............#####################.............
..............#####################.............