Piece : CC_B13
54x80
755x141
.......................................###############
.......................................###############
.......................................###############
......####.........................###################
.....-#=##-........................##.################
......####..........................#+################
.....................................|.###############
....................#####............|.###############
....|...............#####............|.###############
....|...............#####............|.###############
....|................................|.###############
....|................................|.###############
....|................................|.###############
....|................................|.###############
....|..................................###############
....|....####..............####........###############
....|....####..............####........###############
....|....####..............####........###############
....|....####..............####........###############
....|....####..............####......|.###############
....|....####..............####......|.###############
....|....####..............####...|..|################
....|....####..............####...|..|################
...#H##..####..............####..#H###################
..-####-.####..............####..#.###################
...####..####..............####..#+###################
....|....####..............####...|.##################
....|....####..............####...|..|.###############
....|....####..............####...|..|.###############
....|....####..............####...|..|.###############
....|....####..............####...|..|.###############
....|....####..............####...|..|.###############
....|....####..............####...|..|.###############
....|....####..............####...|....###############
....|....####..............####...|....###############
....|....####..............####...|....###############
....|....####..............####...|....###############
.........####..............####...|....###############
.........####..............####...|....###############
.........####..............####...|....###############
.........####..............####...|....###############
.........####..............####...|..|.###############
.........####..............####...|..|.###############
.........####..............####...|..|.###############
.........####..............####...|..|.###############
.........####..............####...|..|.###############
.........####..............####...|..|.###############
.........####..............####..####H################
.........####..............####..#=##|################
.........####..............####..####|################
.........####..............####...###|################
.........####..............####...|..|.###############
.........####..............####...|..|.###############
..####...####..............####...|..|.###############
.-#=##-..####..............####...|..|.###############
..####...####..............####...|..|.###############
.........####..............####......|.###############
.........####..............####......|.###############
.........####..............####......|.###############
.........####..............####......|.###############
.........####..............####......|.###############
.........####..............####......|.###############
.........####..............####......|.###############
.........####..............####......|.###############
.........####..............####..####H################
.........####..............####..####=################
.........####..............####..#####################
.........####..............####...####################
.........####..............####...|..|.###############
.........####..............####...|..|.###############
.........####..............####......|.###############
.........####..............####......|.###############
.........####..............####........###############
.........####..............####........###############
.........####..............####........###############
.........####..............####........###############
.........####..............####........###############
.........####..............####........###############
.........####..............####........###############
.........####..............####........###############
(2,53),(2,56)|(3,23),(3,26)|(3,54),(3,55)|(4,23),(4,24)|(4,54),(4,55)|(5,23),(5,24)|(6,3),(6,6)|(6,53),(6,56)|(7,4),(7,5)|(7,23),(7,26)|(8,4),(8,5)|(9,15),(9,80)|(10,3),(10,6)|(13,15),(13,80)|(20,7),(20,10)|(25,7),(25,10)|(27,15),(27,80)|(31,15),(31,80)|(33,23),(33,26)|(33,47),(33,50)|(33,64),(33,67)|(34,23),(34,26)|(34,48),(34,49)|(34,50),(34,51)|(34,67),(34,68)|(35,3),(35,5)|(35,23),(35,26)|(35,48),(35,49)|(36,5),(36,6)|(36,26),(36,27)|(37,4),(37,6)|(37,47),(37,51)|(37,64),(37,66)|(38,4),(38,6)|(38,21),(38,23)|(38,47),(38,51)|(38,64),(38,66)|(39,0),(39,3)|(39,6),(39,21)|(39,27),(39,47)|(39,51),(39,64)|(39,68),(39,80)|
(6,3),(10,3)|(35,3),(39,3)|(7,4),(8,4)|(37,4),(38,4)|(7,5),(8,5)|(35,5),(36,5)|(6,6),(10,6)|(36,6),(37,6)|(38,6),(39,6)|(20,7),(25,7)|(20,10),(25,10)|(9,15),(13,15)|(27,15),(31,15)|(38,21),(39,21)|(3,23),(4,23)|(5,23),(7,23)|(33,23),(34,23)|(35,23),(38,23)|(4,24),(5,24)|(3,26),(7,26)|(33,26),(34,26)|(35,26),(36,26)|(36,27),(39,27)|(33,47),(37,47)|(38,47),(39,47)|(34,48),(35,48)|(34,49),(35,49)|(33,50),(34,50)|(34,51),(37,51)|(38,51),(39,51)|(2,53),(6,53)|(3,54),(4,54)|(3,55),(4,55)|(2,56),(6,56)|(33,64),(37,64)|(38,64),(39,64)|(37,66),(38,66)|(33,67),(34,67)|(34,68),(39,68)|(9,80),(13,80)|(27,80),(31,80)|
None|
None|
(4.5,8),(4.5,23)|(4.5,26),(4.5,37)|(34.5,21),(34.5,23)|(34.5,25),(34.5,47)|(34.5,51),(34.5,56)|(34.5,68),(34.5,70)|(37.5,5),(37.5,14)|(37.5,19),(37.5,23)|(37.5,27),(37.5,33)|(37.5,41),(37.5,47)|(37.5,48),(37.5,64)|(37.5,68),(37.5,72)|
(5,4.5),(6,4.5)|(10,4.5),(11,4.5)|(37,5.5),(38,5.5)|(2,24.5),(3,24.5)|(7,24.5),(8,24.5)|(34,25.5),(35,25.5)|(1,54.5),(2,54.5)|(6,54.5),(7,54.5)|
end file : CC_B13