Pièce : CC_B08
taille : 48x78
................................................
................................................
................................##..............
....|...........................##..|...........
....|..#####....................##..|...........
...|H|##=#=##||H..............|.##..|...........
....|..#####...|..............|.##..|.####......
....|..........|..............|.##..|.###/......
....|..........|..............|.##..|.##...|....
....|...####...|..............######H###...|....
....|.#############.........########=#####.#....
.####################.....#####################.
.####......................................####.
.##=........................................=##.
.#######HHHH##########....#####################.
........|..|.##............####################.
........|..|.##............####################.
........+--+...............####################.
........|..|...............##=#=###############.
...........|...............##|#|###############.
........---+.................|.|.##############.
........|..|.................|.|................
........|..|.............|.....|................
........+--+.............|......................
........|..|..........|..|......................
........|..|..........+--+..........#...........
........|.####........|..|.....#######..........
........###########...|..|...############.......
.#####################H##H#####################.
.#=#=#................|..|.................=###.
.#####................|..|................#####.
.#####################+.-+#####################.
........############..|..|..#############.......
.........##########...|..|...###########|.......
....|....##########...+--+...##########.|.......
.|..|....##########...|..|...##########.|.......
.|..|....##########...|..|...##########.|.......
.+--+##############..#H##H#..##########.|.#|#...
.|..|##=###########..######..##########.|.###...
.|..|.#############..######..##########.|.###...
.+--+.#############..######..##########.|.###...
.|..|.#############..######..##########.|.###...
.|..|....##########....|.....##########.|..|....
.+--+....##########....|.....##########.|..|....
.|..|....##########....|.....##########.|..|....
.|..|....###########---+-----############--+....
.+--+....##########....|.....##########.|..|....
.|..|....##########....|.....##########.|..|....
.|.......##########....|.....##########.|..|....
.|.....|.##########....|...|.##########.|..|....
.##|#..|.##########........|.##########.|..|....
.##=#..|.##########........|.##########.|..|....
.####..|.#############.....|.###########H#.|....
.####--+-###########=#-----+-###########=#-+....
.####..|.#############.....|.#############......
.......|.#############.....|.##########.........
.......|.##########.|......|.##########.........
.......|.##########.|......|.##########.........
.......|.##########.|......|.##########.........
.......|.##########.|......|.##########.........
.......|.##########.|......|.##########.........
......#H###########.|.....#H###########..##|#...
....+-#=###########.|.....#=###########..####...
....|.#############.|.....#############..####...
....|.#############.|.....#############....|....
....|....##########.|........##########....|....
....|....###########H#.......##########----+--..
....|....###########=#.......##########....|....
....|....#############.......##########....|....
....|....##########..........##########....|....
....|....##########..........##########....|....
....|....##########..........##########....|....
....|....##########..........##########....|....
.###H#################....################.|....
.######=############=#....#=############=##+....
.#####################....################......
.........#############....#############.........
.........#############....#############.........
34,2|7,4|12,4|7,6|7,5|12,6|12,5|7,7|12,7|38,6|42,6|40,8|42,7|41,8|8,9|12,9|32,9|34,9|38,9|6,10|8,10|12,10|19,10|28,10|30,10|40,10|42,10|1,11|5,12|6,11|19,11|21,12|21,11|26,12|26,11|28,11|42,11|44,11|43,12|43,11|47,11|5,13|43,13|1,15|13,15|15,15|22,15|22,14|26,15|26,14|27,15|13,17|15,17|27,20|33,20|33,21|47,21|37,25|36,25|10,26|14,26|31,26|37,26|36,26|38,26|10,27|14,27|19,27|29,27|31,27|38,27|41,27|1,28|6,29|8,28|19,28|29,28|41,28|47,28|42,30|1,32|6,31|8,32|20,32|28,32|41,32|42,31|47,32|8,33|9,33|19,33|20,33|28,33|29,33|39,34|9,37|21,37|27,37|42,37|45,37|6,39|6,42|9,42|21,42|27,42|42,42|45,42|19,46|19,45|39,46|39,45|5,50|19,52|22,52|39,52|42,52|1,55|5,55|39,55|42,55|19,56|22,56|6,61|9,61|26,61|29,61|41,61|45,61|41,64|45,64|6,65|9,65|26,65|29,65|19,66|22,66|19,69|22,69|1,73|9,73|19,73|22,73|26,73|29,73|39,73|42,73|42,75|42,74|1,76|9,76|39,76|42,76|