Pièce : CC_C03
54x118
517x-469
######################################################
######################..........######################
######################..........######################
######################..........######################
######################..........######################
######################..........######################
######################..........######################
######################..........######################
######################..........######################
######################.........#######################
######################..........=#####################
######################....############################
######################....##.#########################
######################.....#+#########################
######################......|...######################
######################......|...######################
######################......|...######################
######################......|...######################
######################......|...######################
######################......|...######################
######################......|...######################
######################......|...######################
######################......|...######################
######################......|...######################
######################......|...######################
######################......|...######################
######################......|...######################
######################......|...######################
######################......|...######################
######################......|...######################
######################......|...######################
######################......|...######################
######################......|...######################
######################......|...######################
######################......|...######################
######################......|...######################
######################......|...######################
######################......|...######################
######################......|...######################
######################......|...######################
######################......|...######################
######################......|...######################
######################......|...######################
######################......|...######################
######################......|...######################
######################......|...######################
######################......|...######################
######################......|...######################
######################......|...######################
######################......|...######################
######################......|...######################
######################......|...######################
######################......|...######################
######################......|...######################
######################......|...######################
######################......|...######################
######################......|...######################
######################......|...######################
######################......|...######################
######################......|...######################
######################......|...######################
######################......|...######################
######################......|...######################
######################......|...######################
######################......|...######################
######################..........######################
####################=...........######################
######################..........######################
#########################.......######################
######################..........######################
######################..........######################
######################..........######################
######################..........######################
######################..........######################
######################..........######################
######################..........######################
######################..........######################
######################..........######################
######################..........######################
######################..........######################
######################..........######################
######################..........######################
######################..........######################
######################..........######################
######################..........######################
######################..........######################
##########..........##..........##..........##########
##########..................................##########
##########..................................##########
##########..................................##########
##########..................................##########
##########..................................##########
##########..................................##########
##########..................................##########
##########.............|....................##########
##########.............|....................##########
########=..............|....................##########
###########...####...|.|............####....##########
##########...........||||...................##########
##########...........++++...................##########
##########............||....................##########
##########.............|......|.............##########
##########.............|......|.............##########
########...............|......|...............########
########...............|......|...............########
######=................|......|.......|........=######
########...............|..##..|.......|...|...########
######=................|..###.|.......#...|....=######
########...............########.......|...|...########
######=..............############.....|.|.|....=######
########...........################...|.|.|...########
##########.......####################.|.|.|.##########
######################################H#H#H###########
##########################################=###########
######################################################
######################################################
######################################################
######################################################
(6,105),(6,106)|(6,107),(6,108)|(6,109),(6,110)|(8,96),(8,97)|(8,103),(8,105)|(8,106),(8,107)|(8,108),(8,109)|(8,110),(8,111)|(10,86),(10,96)|(10,98),(10,103)|(10,111),(10,112)|(11,97),(11,98)|(14,97),(14,98)|(17,111),(17,112)|(18,97),(18,98)|(19,110),(19,111)|(20,66),(20,67)|(20,86),(20,87)|(21,109),(21,110)|(22,1),(22,66)|(22,67),(22,68)|(22,69),(22,87)|(23,108),(23,109)|(25,68),(25,69)|(26,11),(26,13)|(26,106),(26,108)|(27,13),(27,14)|(28,12),(28,14)|(28,106),(28,107)|(29,12),(29,14)|(29,107),(29,108)|(31,9),(31,10)|(31,108),(31,109)|(32,1),(32,9)|(32,14),(32,87)|(33,10),(33,11)|(33,109),(33,110)|(34,86),(34,87)|(35,110),(35,111)|(36,97),(36,98)|(37,111),(37,112)|(38,107),(38,108)|(38,112),(38,113)|(39,107),(39,108)|(39,112),(39,113)|(40,97),(40,98)|(40,112),(40,113)|(41,112),(41,113)|(42,112),(42,114)|(43,112),(43,114)|(44,86),(44,103)|(44,111),(44,112)|(46,103),(46,105)|(46,106),(46,107)|(46,108),(46,109)|(46,110),(46,111)|(48,105),(48,106)|(48,107),(48,108)|(48,109),(48,110)|
(22,1),(32,1)|(31,9),(32,9)|(31,10),(33,10)|(26,11),(33,11)|(28,12),(29,12)|(26,13),(27,13)|(27,14),(28,14)|(29,14),(32,14)|(20,66),(22,66)|(20,67),(22,67)|(22,68),(25,68)|(22,69),(25,69)|(10,86),(20,86)|(34,86),(44,86)|(20,87),(22,87)|(32,87),(34,87)|(8,96),(10,96)|(8,97),(11,97)|(14,97),(18,97)|(36,97),(40,97)|(10,98),(11,98)|(14,98),(18,98)|(36,98),(40,98)|(8,103),(10,103)|(44,103),(46,103)|(6,105),(8,105)|(46,105),(48,105)|(6,106),(8,106)|(26,106),(28,106)|(46,106),(48,106)|(6,107),(8,107)|(28,107),(29,107)|(38,107),(39,107)|(46,107),(48,107)|(6,108),(8,108)|(23,108),(26,108)|(29,108),(31,108)|(38,108),(39,108)|(46,108),(48,108)|(6,109),(8,109)|(21,109),(23,109)|(31,109),(33,109)|(46,109),(48,109)|(6,110),(8,110)|(19,110),(21,110)|(33,110),(35,110)|(46,110),(48,110)|(8,111),(10,111)|(17,111),(19,111)|(35,111),(37,111)|(44,111),(46,111)|(10,112),(17,112)|(37,112),(38,112)|(39,112),(40,112)|(41,112),(42,112)|(43,112),(44,112)|(38,113),(39,113)|(40,113),(41,113)|(42,114),(43,114)|


(21.5,97),(21.5,100)|(22.5,98),(22.5,101)|(23.5,94),(23.5,108)|(24.5,98),(24.5,100)|(28.5,13),(28.5,65)|(30.5,101),(30.5,108)|(38.5,105),(38.5,107)|(38.5,108),(38.5,112)|(40.5,109),(40.5,112)|(42.5,106),(42.5,112)|
(28,13.5),(29,13.5)|(21,99.5),(25,99.5)|
end file : CC_C03