Pièce : CC_H01
taille : 362x35
............................................................................................................................................................................................................................................................................................................................/#############################################
......................................................................................................................................................................................................................................................................................................................................./##################################
.......#................................................................................................................................................................................................................................................................................................................................/#################################
.......#................................................................................................................................................................................................................................................................................................................................./################################
.......#.....................................................................................................................................................................................................................................................................................................................................#############################
....#..#.....................................................................................................................................................................................................................................................................................................................................#############################
...##HH##.......................................................##HH##.......................................................................................................................................................................................................................................................................#############################
...##..##.......................................................##..##.......................................................................................................................................................................................................................................................................#############################
...##--##.......................................................##..##.......................................................................................................................................................................................................................................................................#############################
...##..##.......................................................##--##.......................................................................................................................................................................................................................................................................#############################
....#..#.........................................................#..#........................................................................................................................................................................................................................................................................#############################
....+--+.........................................................#..#.......................................................................................................................................................................................................................................................................##############################
....#..#.........................................................+---.......................................................................................................................................................................................................................................................................##############################
....#..#.........................................................#..........................................................................................................................................................................................................................................................................##############################
....+--+.........................................................#.........................................................................................................................................................................................................................................................................###############################
....#..#...........................................................................................................................................................................#...................................................................................................................##........................##....###################################
....#..#............................................................#............................................................................................................--######################################################################################################################################################=################################
....+--+............................................................+..............................................................................................................#######################################################################################################################################################################################
....#..#............................................................#............................................................................................................--#######################################################################################################################################################################################
....#..#............................................................#.................................................................................................................................................................................................................................................................####################################
....+--+.........................................................+--+.................................................................................................................................................................................................................................................................####################################
....#..#.........................................................#..#..................................................................................................................................................................................................................................................................=##################################
....#..#.........................................................#..#.................................................................................................................................................................................................................................................................####################################
....+--+.........................................................+--+..................................................................................................................................................................................................................................................................=##################################
....#..#.........................................................#..#.................................................................................................................................................................................................................................................................####################################
....###H#.......................................................#H##H#...........................................................................................................--#######################################################################################################################################################################################
...######........................#..............................#######...........................##.............................................................#######...........#######################################################################################################################################################################################
..#####################..........###################################################################........############################################################.........--#######################################################################################################################################################################################
..#########...................................................##########...............................................................................................#...........#...................................................................................................................##........................##.......################################
..#######=.....................................................=######=.....................................................................................................................................................................................................................................................................##############################
..######################.......##########################################################################.....#######################################################.......................................................................................................................................................................##############################
....#..#.........................................................#..#........................................................................................................................................................................................................................................................................#############################
....#..#.........................................................#..#........................................................................................................................................................................................................................................................................#############################
....+--+.........................................................+--+.......................................................................................................................................................................................................................................................................##############################
....#..#.........................................................#..#...............................................................................................................................................................................................................................................................######################################