Pièce : UW_A15
taille : 48x35
################################################
################################################
################################################
################################################
#############################################=##
#############################################.##
#############################################.##
######################=.......###############.##
#############################.###############.##
#############################.###############.##
#############################.###############.##
#############################.###############.##
#############################.###############.##
#############################.###############.##
######################........................##
######################.######.##################
######################.######.##################
######################.######.##################
######################.######.##################
######################.######.##################
######################................##########
#############################.#######.##########
#############################.#######.##########
#############################.#######=##########
#############################.##################
#############################.##################
#############################.##################
#############################.##################
#############################=##################
################################################
################################################
################################################
################################################
################################################
################################################
(22,7),(22,8)|(22,14),(22,21)|(23,15),(23,20)|(29,8),(29,14)|(29,15),(29,20)|(29,21),(29,29)|(30,7),(30,14)|(30,15),(30,20)|(30,21),(30,29)|(37,21),(37,24)|(38,20),(38,24)|(45,4),(45,14)|(46,4),(46,15)|
(45,4),(46,4)|(22,7),(30,7)|(22,8),(29,8)|(22,14),(29,14)|(30,14),(45,14)|(23,15),(29,15)|(30,15),(46,15)|(23,20),(29,20)|(30,20),(38,20)|(22,21),(29,21)|(30,21),(37,21)|(37,24),(38,24)|(29,29),(30,29)|




