Pièce : UW_B01
taille : 104x44
#############/###################/###############/######################################################
############/#####################/#############/#######################################################
########################################################################################################
##################################################################....|.....|......####...#.###..####...
#######################################################################################...#.###..#######
############/#####################/#############/######################################...#.#|#..#######
#############/###################/###############/#####################################...|..|.....|....
#######################################################################################...|..|.....|....
###############################################################.|.....|.....|.............|..|.....|....
############################################################....|.....|.....|................|.....|....
###########################################################.....|.....|.....|................|.....#....
#/#######/###########################/#######/#############.....|...........|................|.....#....
/#########/#########################/#########/############..................................|..........
###########/##########/#/##########/###########/###########..................................|..........
############/#####################/#############/##########..................................|..........
##############################################################...............................|..........
#################################################################............................#..........
##############################################################=#####........###....###.......#..........
######################################################################################-.................
######################################################################################..................
######################################################################################-.................
######..........|.|.....................|.|.....................|.|.....................................
####=...........|.|.....................|.|.....................|.|.....................................
######..........|.|.......................|.....................|.|.....................................
####=...........|.|.....................|.|.....................|.|......................|..............
######..........|.|.....................|.|.....................|.|......................|.|............
########........|.|.................#####.|.....................|.|.....................#####...........
##############################################################################################..........
##############################################################################################..........
#############################################################################################...........
##############################################################..............###.............#...........
##############################################################..........................................
##############################################################..........................................
############/#####################/#############/###########............................................
###########/##########/#/##########/###########/##########/.............................................
/#########/#########################/#########/############.............................................
#/#######/###########################/#######/#############.............................................
###########################################################.............................................
###########################################################.............................................
###########################################################.............................................
###########################################################.............................................
#############/###################/###############/##########............................................
############/#####################/#############/###########............................................
############################################################............................................
(0,12),(0,13)|(0,35),(0,36)|(4,22),(4,23)|(4,24),(4,25)|(6,21),(6,22)|(6,23),(6,24)|(6,25),(6,26)|(8,26),(8,27)|(36,26),(36,27)|(41,26),(41,27)|(59,10),(59,15)|(60,9),(60,10)|(60,33),(60,34)|(60,41),(60,44)|(62,15),(62,16)|(62,17),(62,18)|(62,30),(62,33)|(63,8),(63,9)|(63,17),(63,18)|(65,16),(65,17)|(66,3),(66,4)|(68,17),(68,18)|(76,17),(76,18)|(76,30),(76,31)|(79,17),(79,18)|(79,30),(79,31)|(83,3),(83,4)|(83,17),(83,18)|(86,17),(86,21)|(87,3),(87,8)|(88,26),(88,27)|(90,3),(90,6)|(91,3),(91,6)|(92,3),(92,6)|(92,30),(92,31)|(93,5),(93,6)|(93,16),(93,18)|(93,26),(93,27)|(93,29),(93,31)|(94,5),(94,6)|(94,16),(94,18)|(94,27),(94,29)|(95,3),(95,6)|(97,3),(97,6)|(99,10),(99,12)|(100,10),(100,12)|(101,3),(101,4)|(104,3),(104,4)|
(13,0),(14,0)|(33,0),(34,0)|(49,0),(50,0)|(66,3),(83,3)|(87,3),(90,3)|(91,3),(92,3)|(95,3),(97,3)|(101,3),(104,3)|(66,4),(83,4)|(101,4),(104,4)|(93,5),(94,5)|(90,6),(91,6)|(92,6),(93,6)|(94,6),(95,6)|(97,6),(104,6)|(63,8),(87,8)|(60,9),(63,9)|(59,10),(60,10)|(99,10),(100,10)|(0,12),(99,12)|(59,15),(62,15)|(62,16),(65,16)|(93,16),(94,16)|(62,17),(63,17)|(65,17),(68,17)|(76,17),(79,17)|(83,17),(86,17)|(62,18),(63,18)|(68,18),(76,18)|(79,18),(83,18)|(93,18),(94,18)|(6,21),(86,21)|(4,22),(6,22)|(4,23),(6,23)|(4,24),(6,24)|(4,25),(6,25)|(6,26),(8,26)|(36,26),(41,26)|(88,26),(93,26)|(8,27),(36,27)|(41,27),(88,27)|(93,27),(94,27)|(93,29),(94,29)|(62,30),(76,30)|(79,30),(92,30)|(76,31),(79,31)|(92,31),(93,31)|(60,33),(62,33)|(59,41),(60,41)|


(16.5,21),(16.5,27)|(18.5,21),(18.5,27)|(40.5,21),(40.5,23)|(40.5,24),(40.5,26)|(42.5,21),(42.5,27)|(64.5,8),(64.5,12)|(64.5,21),(64.5,27)|(66.5,21),(66.5,27)|(70.5,3),(70.5,4)|(70.5,8),(70.5,11)|(76.5,3),(76.5,4)|(76.5,8),(76.5,12)|(89.5,24),(89.5,26)|(90.5,6),(90.5,9)|(91.5,25),(91.5,26)|(93.5,5),(93.5,16)|(99.5,6),(99.5,10)|
(86,18.5),(86,20.5)|(87,18.5),(87,20.5)|
end file : UW_B01