Piece : SI_A20
48x35
1286x211
################################################
################################################
################################################
################################################
################################################
################################################
################################################
################################################
################################################
##############...............###################
################################################
##############...............###################
################################################
##############..................#....###########
#############...................################
#############........................###########
#############...........................########
#############............................=######
#############.................##........########
#############................#####...###########
##############...........#######################
##############.........#########################
################################################
#################=##############################
################################################
################################################
################################################
################################################
################################################
################################################
################################################
################################################
################################################
################################################
################################################
(13,14),(13,20)|(14,9),(14,10)|(14,11),(14,12)|(14,13),(14,14)|(14,20),(14,22)|(17,23),(17,24)|(18,23),(18,24)|(23,21),(23,22)|(25,20),(25,21)|(29,9),(29,10)|(29,11),(29,12)|(29,19),(29,20)|(30,18),(30,19)|(32,13),(32,15)|(32,18),(32,19)|(33,13),(33,14)|(34,19),(34,20)|(37,13),(37,14)|(37,15),(37,16)|(37,19),(37,20)|(40,16),(40,17)|(40,18),(40,19)|(42,17),(42,18)|
(14,9),(29,9)|(14,10),(29,10)|(14,11),(29,11)|(14,12),(29,12)|(14,13),(32,13)|(33,13),(37,13)|(13,14),(14,14)|(33,14),(37,14)|(32,15),(37,15)|(37,16),(40,16)|(40,17),(42,17)|(30,18),(32,18)|(40,18),(42,18)|(29,19),(30,19)|(32,19),(34,19)|(37,19),(40,19)|(13,20),(14,20)|(25,20),(29,20)|(34,20),(37,20)|(23,21),(25,21)|(14,22),(23,22)|(17,23),(18,23)|(17,24),(18,24)|
None|
None|
None|
None|
end file : SI_A20