Pièce : GW_B08
taille : 110x35
##############################################################################################################
#################################=#=#=########################################################################
#################################.#.#.########################################################################
######...######.##......#######........##########........##..##...#########........##..########....|..|.######
######.......#####......#######..........................##..##....................##..########....|..|.######
######.......#####.......................................##..##....................##..##..........|..|..=####
####=...................................##..........##...##..##.........#######....##..##.........##HH########
########HH#........##############......####......#####...##..##.........##=#=##....######.........##..########
########..#........##=#......####......####......#=###...##..##.........#######....######..........|..|.######
######.|..|........####..........................#####...######.........#######....................+--+..=####
######.+--+..............................................######........./#####/....................|..|.######
######.|..|........................................................................................|..|..=####
######.|..|........................................................................................+--+.######
######.+--+........................................................................................|..|..=####
######.|..|........................................................................................|..|.######
######.|..|........................................................................................+--+.######
######.+--+........................................................................................|..|#######
######.|..|........................................................................................|..########
###########....................|.......####.......................................................##HH########
########..#....................|.......##=#.......................................................##..########
######.+--+....................|.......####........................................................|..|.######
######.|..|....................|...................................................................+--+.######
######.|..|....................|...................................................................|..|.######
######.+--+....................|...............................|...................................|..|..=####
######.|..|....................|...............................|...................................+--+.######
######.|..#....................|.........#.....................|...........|.......................#..|..=####
####=..|.###...................|........##.....................|...........|.......................##.|.######
#############......####......####......####......#####.........|...........|............|.........############
#############......####......####......####......##=##.........|...........|............|.........############
#############......####......####......####......#####.........|...........|............|.........############
###########=.......####.......=##.......=##......#####.........|...........|............|.........############
#############......####......####......####......#####.........|...........|............|.........############
#############/..../####/..../####/..../####/..../#####/....../#H#/......./#H#/......../#H#/....../############
###########################################################################=##################################
##############################################################################################################
(4,6),(4,7)|(4,26),(4,27)|(6,3),(6,6)|(6,9),(6,18)|(6,20),(6,26)|(8,7),(8,9)|(8,19),(8,20)|(9,3),(9,4)|(9,26),(9,27)|(10,7),(10,9)|(10,19),(10,20)|(10,25),(10,26)|(11,7),(11,9)|(11,18),(11,20)|(11,25),(11,26)|(11,30),(11,31)|(12,26),(12,27)|(13,4),(13,6)|(13,27),(13,30)|(15,3),(15,4)|(16,3),(16,4)|(18,3),(18,6)|(19,7),(19,10)|(21,8),(21,9)|(22,8),(22,9)|(23,8),(23,10)|(24,3),(24,5)|(29,8),(29,9)|(29,27),(29,30)|(31,3),(31,5)|(31,30),(31,31)|(33,1),(33,3)|(33,7),(33,9)|(34,1),(34,3)|(35,1),(35,3)|(36,1),(36,3)|(37,1),(37,3)|(38,1),(38,3)|(39,3),(39,4)|(39,7),(39,9)|(39,18),(39,21)|(39,27),(39,30)|(40,6),(40,7)|(40,26),(40,27)|(41,19),(41,20)|(41,25),(41,26)|(41,30),(41,31)|(42,6),(42,7)|(42,19),(42,20)|(42,25),(42,27)|(43,7),(43,9)|(43,18),(43,21)|(49,3),(49,4)|(49,7),(49,10)|(50,8),(50,9)|(51,8),(51,9)|(51,28),(51,29)|(52,6),(52,7)|(52,28),(52,29)|(54,6),(54,10)|(57,3),(57,11)|(59,3),(59,9)|(61,3),(61,9)|(63,3),(63,11)|(63,32),(63,33)|(64,32),(64,33)|(66,3),(66,4)|(74,7),(74,8)|(75,3),(75,4)|(75,7),(75,8)|(75,32),(75,34)|(76,7),(76,8)|(76,32),(76,34)|(77,7),(77,8)|(83,3),(83,9)|(85,3),(85,7)|(87,3),(87,7)|(88,32),(88,33)|(89,5),(89,9)|(89,32),(89,33)|(95,3),(95,5)|(98,6),(98,8)|(98,18),(98,20)|(99,25),(99,27)|(100,6),(100,8)|(100,18),(100,20)|(100,25),(100,26)|(101,26),(101,27)|(102,6),(102,8)|(102,17),(102,20)|(103,16),(103,17)|(104,3),(104,5)|(104,8),(104,9)|(104,10),(104,11)|(104,12),(104,13)|(104,14),(104,16)|(104,20),(104,23)|(104,24),(104,25)|(104,26),(104,27)|(106,5),(106,6)|(106,9),(106,10)|(106,11),(106,12)|(106,13),(106,14)|(106,23),(106,24)|(106,25),(106,26)|
(33,1),(34,1)|(35,1),(36,1)|(37,1),(38,1)|(6,3),(9,3)|(15,3),(16,3)|(18,3),(24,3)|(31,3),(33,3)|(34,3),(35,3)|(36,3),(37,3)|(38,3),(39,3)|(49,3),(57,3)|(59,3),(61,3)|(63,3),(66,3)|(75,3),(83,3)|(85,3),(87,3)|(95,3),(104,3)|(9,4),(13,4)|(15,4),(16,4)|(39,4),(49,4)|(66,4),(75,4)|(24,5),(31,5)|(89,5),(95,5)|(104,5),(106,5)|(4,6),(6,6)|(13,6),(18,6)|(40,6),(42,6)|(52,6),(54,6)|(72,6),(79,6)|(98,6),(100,6)|(102,6),(106,6)|(4,7),(8,7)|(10,7),(11,7)|(19,7),(33,7)|(39,7),(40,7)|(42,7),(43,7)|(49,7),(52,7)|(74,7),(75,7)|(76,7),(77,7)|(85,7),(87,7)|(21,8),(22,8)|(23,8),(29,8)|(50,8),(51,8)|(74,8),(75,8)|(76,8),(77,8)|(98,8),(100,8)|(102,8),(104,8)|(6,9),(8,9)|(10,9),(11,9)|(21,9),(22,9)|(29,9),(33,9)|(39,9),(43,9)|(50,9),(51,9)|(59,9),(61,9)|(83,9),(89,9)|(104,9),(106,9)|(19,10),(23,10)|(49,10),(54,10)|(104,10),(106,10)|(57,11),(63,11)|(104,11),(106,11)|(104,12),(106,12)|(104,13),(106,13)|(104,14),(106,14)|(103,16),(104,16)|(102,17),(103,17)|(6,18),(11,18)|(39,18),(43,18)|(98,18),(100,18)|(8,19),(10,19)|(41,19),(42,19)|(6,20),(8,20)|(10,20),(11,20)|(41,20),(42,20)|(98,20),(100,20)|(102,20),(104,20)|(39,21),(43,21)|(104,23),(106,23)|(104,24),(106,24)|(10,25),(11,25)|(41,25),(42,25)|(99,25),(100,25)|(104,25),(106,25)|(4,26),(6,26)|(9,26),(10,26)|(11,26),(12,26)|(40,26),(41,26)|(100,26),(101,26)|(104,26),(106,26)|(4,27),(9,27)|(12,27),(13,27)|(19,27),(23,27)|(29,27),(33,27)|(39,27),(40,27)|(42,27),(43,27)|(49,27),(54,27)|(98,27),(99,27)|(101,27),(104,27)|(51,28),(52,28)|(51,29),(52,29)|(11,30),(13,30)|(29,30),(31,30)|(39,30),(41,30)|(11,31),(13,31)|(29,31),(31,31)|(39,31),(41,31)|(63,32),(64,32)|(75,32),(76,32)|(88,32),(89,32)|(63,33),(64,33)|(88,33),(89,33)|(75,34),(76,34)|
(13,32),(14,33)|(23,32),(24,33)|(33,32),(34,33)|(43,32),(44,33)|(54,32),(55,33)|(65,32),(66,33)|(72,10),(73,11)|(77,32),(78,33)|(90,32),(91,33)|
(18,33),(19,32)|(28,33),(29,32)|(38,33),(39,32)|(48,33),(49,32)|(61,33),(62,32)|(73,33),(74,32)|(78,11),(79,10)|(86,33),(87,32)|(97,33),(98,32)|
(7.5,9),(7.5,18)|(7.5,27),(10.5,9)|(10.5,18),(10.5,25)|(31.5,18),(31.5,27)|(63.5,23),(63.5,32)|(75.5,25),(75.5,32)|(88.5,27),(88.5,32)|(99.5,3),(99.5,6)|(99.5,8),(99.5,18)|(99.5,20),(102.5,3)|(102.5,6),(102.5,8)|(102.5,17),(102.5,20)|

end file : GW_B08