Piece : SH_C01
156x35
-399x49
.......................................................................................................................................................#####
.......................................................................................................................................................#####
.......................................................................................................................................................#####
........................................................................................................................................................=###
.......................................................................................................................................................#####
........................................................................................................................................................=###
...........................................................................................................................................#################
...........................................................................................................................................#################
...........................................................................................................................................#################
..............................................................................................................................................|....|...#####
..............................................................................................................................................|....|....=###
...........................................................................................................................................###H####H########
..............................................................................................................................................|....|...#####
..............................................................................................................................................|....|...#####
..............................................................................................................................................|....|...#####
..............................................................................................................................................|....|...#####
..............................................................................................................................................|....|...#####
..............................................................................................................................................|....|...#####
#############.................................................................................................................................|....|...#####
#############.................................................................................................................................|....|...#####
#############.................................................................................................................................|....|...#####
###########=..................................................................................................................................|....|....=###
#############.................................................................................................................................|....|...#####
########################################...................................................................................................#################
########################################...................................................................................................#################
########################################.....##.................##.........................................................................#################
#########################################..######..............####....#...................................................................#################
#############################################################################.................................................##############################
#############################################################################.................................................##############################
#############################################################################....##.....................##.............##......=############################
##############################################################################..######..............########.........######...##############################
############################################################################################################################################################
#################################################################################################=################=#########################################
############################################################################################################################################################
############################################################################################################################################################
(11,21),(11,22)|(13,18),(13,21)|(13,22),(13,23)|(40,23),(40,26)|(41,26),(41,27)|(43,26),(43,27)|(45,25),(45,26)|(47,25),(47,26)|(49,26),(49,27)|(63,26),(63,27)|(64,25),(64,26)|(66,25),(66,26)|(67,26),(67,27)|(71,26),(71,27)|(72,26),(72,27)|(77,27),(77,30)|(78,30),(78,31)|(80,30),(80,31)|(81,29),(81,30)|(83,29),(83,30)|(86,30),(86,31)|(97,32),(97,33)|(98,32),(98,33)|(100,30),(100,31)|(104,29),(104,30)|(106,29),(106,30)|(108,30),(108,31)|(114,32),(114,33)|(115,32),(115,33)|(117,30),(117,31)|(119,29),(119,30)|(121,29),(121,30)|(123,30),(123,31)|(126,27),(126,29)|(126,30),(126,31)|(128,29),(128,30)|(139,6),(139,9)|(139,11),(139,12)|(139,23),(139,27)|(142,11),(142,12)|(143,11),(143,12)|(147,11),(147,12)|(148,11),(148,12)|(151,0),(151,3)|(151,4),(151,5)|(151,9),(151,10)|(151,12),(151,21)|(151,22),(151,23)|(153,3),(153,4)|(153,5),(153,6)|(153,10),(153,11)|(153,21),(153,22)|
(151,3),(153,3)|(151,4),(153,4)|(151,5),(153,5)|(139,6),(153,6)|(139,9),(151,9)|(151,10),(153,10)|(139,11),(142,11)|(143,11),(147,11)|(148,11),(153,11)|(139,12),(142,12)|(143,12),(147,12)|(148,12),(151,12)|(0,18),(13,18)|(11,21),(13,21)|(151,21),(153,21)|(11,22),(13,22)|(151,22),(153,22)|(13,23),(40,23)|(139,23),(151,23)|(45,25),(47,25)|(64,25),(66,25)|(40,26),(41,26)|(43,26),(45,26)|(47,26),(49,26)|(63,26),(64,26)|(66,26),(67,26)|(71,26),(72,26)|(41,27),(43,27)|(49,27),(63,27)|(67,27),(71,27)|(72,27),(77,27)|(126,27),(139,27)|(81,29),(83,29)|(104,29),(106,29)|(119,29),(121,29)|(126,29),(128,29)|(77,30),(78,30)|(80,30),(81,30)|(83,30),(86,30)|(100,30),(104,30)|(106,30),(108,30)|(117,30),(119,30)|(121,30),(123,30)|(126,30),(128,30)|(78,31),(80,31)|(86,31),(100,31)|(108,31),(117,31)|(123,31),(126,31)|(97,32),(98,32)|(114,32),(115,32)|(97,33),(98,33)|(114,33),(115,33)|
None|
None|
(142.5,9),(142.5,11)|(142.5,12),(142.5,23)|(147.5,9),(147.5,11)|(147.5,12),(147.5,23)|
None|
end file : SH_C01