Piece : SL_F02
162x78
-608x97
..................................................................................................................................................................
..................................................................................................................................................................
..................................................................................................................................................................
..................................................................................................................................................................
..................................................................................................................................................................
..................................................................................................................................................................
..................................................................................................................................................................
..................................................................................................................................................................
..................................................................................................................................................................
..................................................................................................................................................................
..................................................................................................................................................................
..................................................................................................................................................................
.............................................................####.................................................................................................
.............................................................#=##....................................##...........................................................
...................................................####......####....................######.......########........................................................
..................................................#######....####.................#####=####################......................................................
.................................................##########..####...............#############################.....................................................
................................................#################.............###############################.....................................................
..####.........................................###################..........#################################.....................................................
..##=#.........................................##############################################################.....................................................
..####--.......................................######################################........################.....................................................
..####.........................................####################################...........#############=......................................................
..####.........................................###################################.............##############.....................................................
..####.........................................###################################.............###############....................................................
...............................................###################################.............#################..................................................
..............................................####################################..............###################...............................................
..............................................####################################..............######################............................................
.............................................######################################.............########################..........................................
..####......................................#######################################............###########################.......................................#
#######....................................########################################............############################................................##.####
###########.............................###########################################............################################..........................####=####
###############.......................##############################################...........###################################.....................###########
#################...................################################################...........####################################..................#############
###################................#################################################..........#######################################..............###############
####################................=###############################################..........########################################............################
####################..............##################################################..........#########################################.........##################
#####################............###################################################..........##########################################........##################
#####################............###################################################...........#########################################.......###################
######################..........####################################################............########################################.......###################
#######################.........####################################################............#######################################.......####################
#######################.........####################################################.............######################################.......####################
#######################.........###################################################...............####################################........####################
#######################..........##################################################...............###################################........#####################
#######################..........#################################################.................################################.........######################
########################.........#################################################.................################################.........######################
########################..........###############################################...................##############################.........#######################
########################..........##############################################.....................###########################...........#######################
########################...........############################################.......................#######################..............#######################
########################............#################################...####...........................####################...............########################
#########################.............##########....############............................................############.................#########################
#########################...............#####............###....................................................######...................#########################
#########################...............................................................................................................##########################
##########################............................................................................................................############################
##########################...........................................................................................................#############################
###########################.........................................................................................................##############################
############################.....................................................................................................#################################
#############################..................................................................................................###################################
##############################........................................................######.##########........................###################################
##############################.......................................................#######=####################............#####################################
################################.................................................#################################################################################
##################################.###............................################################################################################################
##################################=######.......................##################################################################################################
#################################################...........######################################################################################################
##################################################################################################################################################################
##################################################################################################################################################################
##################################################################################################################################################################
##################################################################################################################################################################
##################################################################################################################################################################
##################################################################################################################################################################
##################################################################################################################################################################
##################################################################################################################################################################
##################################################################################################################################################################
##################################################################################################################################################################
##################################################################################################################################################################
##################################################################################################################################################################
##################################################################################################################################################################
##################################################################################################################################################################
##################################################################################################################################################################
(2,18),(2,24)|(2,28),(2,29)|(4,19),(4,20)|(5,19),(5,20)|(6,18),(6,24)|(6,28),(6,29)|(7,29),(7,30)|(11,30),(11,31)|(15,31),(15,32)|(17,32),(17,33)|(19,33),(19,34)|(20,34),(20,36)|(21,36),(21,38)|(22,38),(22,39)|(23,39),(23,44)|(24,44),(24,49)|(25,49),(25,52)|(26,52),(26,54)|(27,54),(27,55)|(28,55),(28,56)|(29,56),(29,57)|(30,57),(30,59)|(32,38),(32,42)|(32,59),(32,60)|(33,36),(33,38)|(33,42),(33,45)|(34,35),(34,36)|(34,45),(34,47)|(34,60),(34,62)|(35,33),(35,34)|(35,47),(35,48)|(35,60),(35,62)|(36,32),(36,33)|(36,48),(36,49)|(37,34),(37,35)|(38,31),(38,32)|(38,49),(38,50)|(38,60),(38,61)|(40,30),(40,31)|(40,50),(40,51)|(41,61),(41,62)|(43,29),(43,30)|(44,28),(44,29)|(45,27),(45,28)|(45,50),(45,51)|(46,25),(46,27)|(47,18),(47,25)|(48,17),(48,18)|(48,49),(48,50)|(49,16),(49,17)|(49,62),(49,63)|(50,15),(50,16)|(51,14),(51,15)|(52,49),(52,50)|(55,14),(55,15)|(57,15),(57,16)|(57,50),(57,51)|(59,16),(59,17)|(60,50),(60,51)|(60,62),(60,63)|(61,12),(61,17)|(62,13),(62,14)|(63,13),(63,14)|(64,49),(64,50)|(64,61),(64,62)|(65,12),(65,18)|(66,18),(66,19)|(66,60),(66,61)|(69,48),(69,49)|(72,48),(72,49)|(76,18),(76,19)|(76,48),(76,49)|(78,17),(78,18)|(79,47),(79,48)|(80,16),(80,17)|(80,46),(80,47)|(81,45),(81,46)|(81,59),(81,60)|(82,15),(82,16)|(82,22),(82,27)|(82,43),(82,45)|(83,21),(83,22)|(83,27),(83,31)|(83,41),(83,43)|(84,31),(84,41)|(85,14),(85,15)|(85,20),(85,21)|(85,58),(85,59)|(86,57),(86,58)|(87,15),(87,16)|(88,15),(88,16)|(91,14),(91,15)|(92,57),(92,59)|(93,20),(93,21)|(93,57),(93,59)|(94,21),(94,22)|(94,33),(94,37)|(95,22),(95,25)|(95,28),(95,33)|(95,37),(95,38)|(96,25),(96,28)|(96,38),(96,40)|(97,40),(97,41)|(98,14),(98,15)|(98,41),(98,43)|(99,43),(99,45)|(100,45),(100,46)|(101,13),(101,14)|(101,46),(101,47)|(102,47),(102,48)|(103,13),(103,14)|(103,48),(103,49)|(103,57),(103,58)|(106,14),(106,15)|(107,21),(107,22)|(108,15),(108,16)|(108,49),(108,50)|(109,16),(109,21)|(109,22),(109,23)|(110,23),(110,24)|(112,24),(112,25)|(112,50),(112,51)|(113,58),(113,59)|(115,25),(115,26)|(118,26),(118,27)|(118,50),(118,51)|(120,27),(120,28)|(120,49),(120,50)|(122,28),(122,29)|(123,29),(123,30)|(123,48),(123,49)|(125,47),(125,48)|(125,58),(125,59)|(127,30),(127,31)|(127,56),(127,58)|(128,46),(128,47)|(129,55),(129,56)|(130,31),(130,32)|(130,45),(130,46)|(131,32),(131,33)|(131,43),(131,45)|(132,54),(132,55)|(133,33),(133,34)|(133,42),(133,43)|(133,53),(133,54)|(134,34),(134,35)|(134,41),(134,42)|(134,52),(134,53)|(135,35),(135,36)|(135,39),(135,41)|(136,36),(136,39)|(136,51),(136,52)|(137,49),(137,51)|(138,48),(138,49)|(139,45),(139,48)|(140,43),(140,45)|(141,42),(141,43)|(142,39),(142,42)|(143,37),(143,39)|(144,35),(144,37)|(146,34),(146,35)|(147,33),(147,34)|(149,32),(149,33)|(151,31),(151,32)|(153,30),(153,31)|(155,29),(155,30)|(157,29),(157,31)|(158,29),(158,31)|(161,28),(161,29)|
(61,12),(65,12)|(62,13),(63,13)|(101,13),(103,13)|(51,14),(55,14)|(62,14),(63,14)|(85,14),(91,14)|(98,14),(101,14)|(103,14),(106,14)|(50,15),(51,15)|(55,15),(57,15)|(82,15),(85,15)|(87,15),(88,15)|(91,15),(98,15)|(106,15),(108,15)|(49,16),(50,16)|(57,16),(59,16)|(80,16),(82,16)|(87,16),(88,16)|(108,16),(109,16)|(48,17),(49,17)|(59,17),(61,17)|(78,17),(80,17)|(2,18),(6,18)|(47,18),(48,18)|(65,18),(66,18)|(76,18),(78,18)|(4,19),(5,19)|(66,19),(76,19)|(4,20),(5,20)|(85,20),(93,20)|(83,21),(85,21)|(93,21),(94,21)|(107,21),(109,21)|(82,22),(83,22)|(94,22),(95,22)|(107,22),(109,22)|(109,23),(110,23)|(2,24),(6,24)|(110,24),(112,24)|(46,25),(47,25)|(95,25),(96,25)|(112,25),(115,25)|(115,26),(118,26)|(45,27),(46,27)|(82,27),(83,27)|(118,27),(120,27)|(2,28),(6,28)|(44,28),(45,28)|(95,28),(96,28)|(120,28),(122,28)|(161,28),(162,28)|(0,29),(2,29)|(6,29),(7,29)|(43,29),(44,29)|(122,29),(123,29)|(155,29),(157,29)|(158,29),(161,29)|(7,30),(11,30)|(40,30),(43,30)|(123,30),(127,30)|(153,30),(155,30)|(11,31),(15,31)|(38,31),(40,31)|(83,31),(84,31)|(127,31),(130,31)|(151,31),(153,31)|(157,31),(158,31)|(15,32),(17,32)|(36,32),(38,32)|(130,32),(131,32)|(149,32),(151,32)|(17,33),(19,33)|(35,33),(36,33)|(94,33),(95,33)|(131,33),(133,33)|(147,33),(149,33)|(19,34),(20,34)|(35,34),(37,34)|(133,34),(134,34)|(146,34),(147,34)|(34,35),(37,35)|(134,35),(135,35)|(144,35),(146,35)|(20,36),(21,36)|(33,36),(34,36)|(135,36),(136,36)|(94,37),(95,37)|(143,37),(144,37)|(21,38),(22,38)|(32,38),(33,38)|(95,38),(96,38)|(22,39),(23,39)|(135,39),(136,39)|(142,39),(143,39)|(96,40),(97,40)|(83,41),(84,41)|(97,41),(98,41)|(134,41),(135,41)|(32,42),(33,42)|(133,42),(134,42)|(141,42),(142,42)|(82,43),(83,43)|(98,43),(99,43)|(131,43),(133,43)|(140,43),(141,43)|(23,44),(24,44)|(33,45),(34,45)|(81,45),(82,45)|(99,45),(100,45)|(130,45),(131,45)|(139,45),(140,45)|(80,46),(81,46)|(100,46),(101,46)|(128,46),(130,46)|(34,47),(35,47)|(79,47),(80,47)|(101,47),(102,47)|(125,47),(128,47)|(35,48),(36,48)|(69,48),(72,48)|(76,48),(79,48)|(102,48),(103,48)|(123,48),(125,48)|(138,48),(139,48)|(24,49),(25,49)|(36,49),(38,49)|(48,49),(52,49)|(64,49),(69,49)|(72,49),(76,49)|(103,49),(108,49)|(120,49),(123,49)|(137,49),(138,49)|(38,50),(40,50)|(45,50),(48,50)|(52,50),(57,50)|(60,50),(64,50)|(108,50),(112,50)|(118,50),(120,50)|(40,51),(45,51)|(57,51),(60,51)|(112,51),(118,51)|(136,51),(137,51)|(25,52),(26,52)|(134,52),(136,52)|(133,53),(134,53)|(26,54),(27,54)|(132,54),(133,54)|(27,55),(28,55)|(129,55),(132,55)|(28,56),(29,56)|(127,56),(129,56)|(29,57),(30,57)|(86,57),(92,57)|(93,57),(103,57)|(85,58),(86,58)|(103,58),(113,58)|(125,58),(127,58)|(30,59),(32,59)|(81,59),(85,59)|(92,59),(93,59)|(113,59),(125,59)|(32,60),(34,60)|(35,60),(38,60)|(66,60),(81,60)|(38,61),(41,61)|(64,61),(66,61)|(34,62),(35,62)|(41,62),(49,62)|(60,62),(64,62)|(49,63),(60,63)|
None|
None|
None|
(6,20.5),(8,20.5)|
end file : SL_F02