Pièce : SU_A42
taille : 48x35
################################################
################################################
################################################
################################################
################################################
################################################
################################################
##################.#############################
##################..############################
##################..############################
##################...###########################
#################....###########################
#################....###########################
################################################
################......##########################
###############.......##########################
###############....#############################
####################..../#######################
#############............#######################
############...............#####################
###########/..................../####.../#######
##########/..............................#######
########..................................######
######/...................................######
######...................................../####
######......................................####
#######/........#################..........#####
########........###............##......../######
########/..../######..........#####.../#########
#########...####################################
###################.....................########
##########=#####################################
################################################
################################################
################################################
(8,22),(8,23)|(10,31),(10,32)|(11,31),(11,32)|(12,19),(12,29)|(13,18),(13,19)|(15,15),(15,17)|(16,14),(16,15)|(16,26),(16,28)|(17,11),(17,13)|(18,7),(18,11)|(19,7),(19,8)|(19,16),(19,17)|(19,27),(19,28)|(19,30),(19,31)|(20,8),(20,10)|(20,17),(20,18)|(20,28),(20,29)|(21,10),(21,13)|(22,14),(22,16)|(27,19),(27,20)|(30,28),(30,29)|(31,27),(31,28)|(33,26),(33,28)|(35,28),(35,29)|(37,20),(37,21)|(40,30),(40,31)|(42,22),(42,24)|(43,26),(43,27)|
(18,18),(19,7)|(19,19),(20,8)|(20,20),(21,10)|(17,17),(18,11)|(17,17),(21,13)|(16,16),(22,14)|(15,15),(16,15)|(19,19),(22,16)|(15,15),(19,17)|(13,13),(20,18)|(12,12),(13,19)|(25,25),(27,19)|(27,27),(37,20)|(8,8),(41,22)|(6,6),(16,26)|(33,33),(43,26)|(19,19),(31,27)|(16,16),(19,28)|(20,20),(30,28)|(31,31),(33,28)|(12,12),(20,29)|(30,30),(35,29)|(9,9),(12,30)|(19,19),(40,30)|(10,10),(11,31)|(19,19),(40,31)|(10,10),(11,32)|
(7,26),(8,27)|(8,28),(9,29)|(24,17),(25,18)|(32,20),(33,21)|(40,20),(41,21)|(43,24),(44,25)|
(6,24),(7,23)|(10,22),(12,20)|(13,29),(14,28)|(38,29),(39,28)|(41,28),(42,27)|


end file : SU_A42