Pièce : SU_A38
taille : 54x35
######################################################
######################################################
######################################################
######################################################
######################################################
######################################################
######################################################
######################################################
######################################################
#########################=#=##########################
#########################|#|##########################
########################.|.|..########################
#####################/.....|../#######################
#####################..........#######################
####################.........../######################
####################............/#####################
####################..............####################
###################/................##################
################/.................../#################
################.....................#################
################.....................#################
################/....................#################
#################........|........../#################
#################........|.|........##################
###############/.........|.|........##################
###############......../#H#H#/....../#################
##############/......./#######/......../##############
#########/............#########............./#########
########/.............#########............../########
######=...............###########...............=#####
######################################################
##########...........=#########=............##########
######################################################
######################################################
######################################################
6,29|6,30|8,29|10,27|10,31|10,32|14,27|15,25|15,26|16,19|16,21|16,24|17,18|17,22|17,24|19,18|20,14|20,17|21,13|21,14|22,12|22,27|22,30|22,31|22,32|24,11|24,12|24,25|25,9|26,9|27,9|28,9|29,25|30,11|30,12|31,13|31,14|31,27|31,29|31,31|31,32|33,16|33,29|33,30|34,16|34,17|36,17|36,18|36,23|36,25|37,19|37,22|37,26|39,26|40,27|44,27|44,31|44,32|46,29|49,29|49,30|
(6,29),(6,30)|(8,29),(10,27)|(10,31),(10,32)|(14,27),(15,25)|(15,26),(16,19)|(16,21),(16,24)|(17,18),(17,22)|(17,24),(19,18)|(20,14),(20,17)|(21,13),(21,14)|(22,12),(22,27)|(22,30),(22,31)|(22,32),(24,11)|(24,12),(24,25)|(25,9),(26,9)|(27,9),(28,9)|(29,25),(30,11)|(30,12),(31,13)|(31,14),(31,27)|(31,29),(31,31)|(31,32),(33,16)|(33,29),(33,30)|(34,16),(34,17)|(36,17),(36,18)|(36,23),(36,25)|(37,19),(37,22)|(37,26),(39,26)|(40,27),(44,27)|(44,31),(44,32)|(46,29),(49,29)|
(25,9),(26,9)|(27,9),(28,9)|(24,11),(30,11)|(22,12),(24,12)|(30,12),(21,13)|(31,13),(20,14)|(21,14),(31,14)|(33,16),(34,16)|(20,17),(34,17)|(36,17),(17,18)|(19,18),(36,18)|(16,19),(37,19)|(16,21),(17,22)|(37,22),(36,23)|(16,24),(17,24)|(15,25),(24,25)|(29,25),(36,25)|(15,26),(37,26)|(39,26),(10,27)|(14,27),(22,27)|(31,27),(40,27)|(44,27),(6,29)|(8,29),(31,29)|(33,29),(46,29)|(49,29),(6,30)|(22,30),(33,30)|(49,30),(10,31)|(22,31),(31,31)|(44,31),(10,32)|(22,32),(31,32)|