Pièce : SU_A25
taille : 54x35
################################....|..../############
######################################################
###############################....###....############
######################################################
#################################...|...##############
###############################=....|....=############
#################################...|...##############
###############################=....|....=############
####################################H#################
################################/...|.../#############
###########/.##=#=#=##...../###/....|..../############
###########../#|#|#|#/......./#.....|.......##########
#########/.....|.|.|................|......./#########
#########......|...|................|............#####
########/......|...|................|.......####.#####
########...........|................|.......####.#####
########/..........|................|.......####.#####
#########.................####......|......#####.#####
#########.................####......|......#####.#####
########/.................####......|......#####.#####
######=...................####......|......#####.#####
########..................####......|......#####.#####
#########/.......|........####......|......#####.#####
##########.......|........####......|......#####.#####
##########.......|..................|............#####
######################################################
#####...........###......######....###...........#####
#####.##########################################.#####
#####.##.........|.......######............#####.#####
#####....###/....|..../#######/............#####=#####
#################H############.............###########
#################=############............./##########
##############################/.............##########
###############################............/##########
################################/..........###########
5,26|5,30|6,20|6,21|6,27|6,29|8,21|8,22|8,28|8,29|9,29|9,30|10,25|11,12|13,10|15,10|16,10|16,26|16,27|17,10|17,32|18,10|18,32|19,10|19,26|19,27|20,10|22,10|25,26|25,27|25,28|25,29|26,17|26,24|30,17|30,24|31,2|31,3|31,5|31,6|31,7|31,8|31,12|31,26|31,27|31,28|31,34|32,0|32,1|33,4|33,5|33,6|33,7|35,2|35,3|35,26|35,27|38,2|38,3|38,26|38,27|40,4|40,5|40,6|40,7|42,2|42,3|42,5|42,6|42,7|42,8|43,17|43,24|43,28|43,35|44,11|44,14|44,17|48,14|48,24|48,27|48,30|49,13|49,25|49,26|49,30|
(5,26),(5,30)|(6,20),(6,21)|(6,27),(6,29)|(8,21),(8,22)|(8,28),(8,29)|(9,29),(9,30)|(10,25),(11,12)|(13,10),(15,10)|(16,10),(16,26)|(16,27),(17,10)|(17,32),(18,10)|(18,32),(19,10)|(19,26),(19,27)|(20,10),(22,10)|(25,26),(25,27)|(25,28),(25,29)|(26,17),(26,24)|(30,17),(30,24)|(31,2),(31,3)|(31,5),(31,6)|(31,7),(31,8)|(31,12),(31,26)|(31,27),(31,28)|(31,34),(32,0)|(32,1),(33,4)|(33,5),(33,6)|(33,7),(35,2)|(35,3),(35,26)|(35,27),(38,2)|(38,3),(38,26)|(38,27),(40,4)|(40,5),(40,6)|(40,7),(42,2)|(42,3),(42,5)|(42,6),(42,7)|(42,8),(43,17)|(43,24),(43,28)|(43,35),(44,11)|(44,14),(44,17)|(48,14),(48,24)|(48,27),(48,30)|(49,13),(49,25)|(49,26),(49,30)|
(32,0),(32,1)|(31,2),(35,2)|(38,2),(42,2)|(31,3),(35,3)|(38,3),(42,3)|(33,4),(40,4)|(31,5),(33,5)|(40,5),(42,5)|(31,6),(33,6)|(40,6),(42,6)|(31,7),(33,7)|(40,7),(42,7)|(31,8),(42,8)|(13,10),(15,10)|(16,10),(17,10)|(18,10),(19,10)|(20,10),(22,10)|(44,11),(11,12)|(31,12),(49,13)|(44,14),(48,14)|(26,17),(30,17)|(43,17),(44,17)|(6,20),(6,21)|(8,21),(8,22)|(26,24),(30,24)|(43,24),(48,24)|(10,25),(49,25)|(5,26),(16,26)|(19,26),(25,26)|(31,26),(35,26)|(38,26),(49,26)|(6,27),(16,27)|(19,27),(25,27)|(31,27),(35,27)|(38,27),(48,27)|(8,28),(25,28)|(31,28),(43,28)|(6,29),(8,29)|(9,29),(25,29)|(5,30),(9,30)|(48,30),(49,30)|(17,32),(18,32)|(31,34),(43,35)|