Pièce : SU_A32
taille : 48x35
################################################
################################################
################################################
#######################################=########
#######################################|########
######################################.|.#######
#################################......|..=#####
################################.......|########
################################...#############
################################...#############
################################.....###########
#################################.....##########
##################################.......#######
####################################......######
####################################.......#####
####################################.......#####
##############........#############........#####
###########.................................=###
#########...............................########
#######..............................###########
######.........../##/..............#############
#####............####...........################
#####............/##/.......####################
####...........#################################
##=.........####################################
#####......##=##################################
################################################
################################################
################################################
################################################
################################################
################################################
################################################
################################################
################################################
(2,24),(2,25)|(4,23),(4,24)|(5,21),(5,23)|(5,25),(5,26)|(6,20),(6,21)|(7,19),(7,20)|(9,18),(9,19)|(11,17),(11,18)|(11,25),(11,26)|(12,24),(12,25)|(13,25),(13,26)|(14,16),(14,17)|(14,25),(14,26)|(15,23),(15,24)|(22,16),(22,17)|(28,22),(28,23)|(32,7),(32,11)|(32,21),(32,22)|(33,6),(33,7)|(33,11),(33,12)|(34,12),(34,13)|(35,8),(35,10)|(35,16),(35,17)|(35,20),(35,21)|(36,13),(36,16)|(37,10),(37,11)|(37,19),(37,20)|(38,5),(38,6)|(38,11),(38,12)|(39,3),(40,3)|(40,18),(40,19)|(41,5),(41,6)|(41,12),(41,13)|(42,13),(42,14)|(43,6),(43,7)|(43,14),(43,17)|(45,17),(45,18)|
(39,3),(40,3)|(38,5),(41,5)|(33,6),(38,6)|(41,6),(43,6)|(32,7),(33,7)|(43,7),(35,8)|(35,10),(37,10)|(32,11),(33,11)|(37,11),(38,11)|(33,12),(34,12)|(38,12),(41,12)|(34,13),(36,13)|(41,13),(42,13)|(42,14),(43,14)|(14,16),(22,16)|(35,16),(36,16)|(11,17),(14,17)|(22,17),(35,17)|(43,17),(45,17)|(9,18),(11,18)|(40,18),(45,18)|(7,19),(9,19)|(37,19),(40,19)|(6,20),(7,20)|(35,20),(37,20)|(5,21),(6,21)|(32,21),(35,21)|(28,22),(32,22)|(4,23),(5,23)|(15,23),(28,23)|(2,24),(4,24)|(12,24),(15,24)|(2,25),(5,25)|(11,25),(12,25)|(13,25),(14,25)|(5,26),(11,26)|(13,26),(14,26)|(20,20),(21,21)|(20,22),(21,23)|(17,21),(18,20)|(17,23),(18,22)|