Pièce : SU_A10
taille : 54x35
########..............................................
########..............................................
########..............................................
########..............................................
########.............................................#
########............................................##
########......................................../#####
#######/........................................######
######/.................................|.......######
####=...................................|.......######
######..................................|.......######
####=...................................|.......######
######..................................|.......######
####=........................|..........|...|...######
######............##.........|..........|...|....=####
####=...........#####........|....|.....|...|...######
#########################/...|....|.....|...|...######
#############=############/..|....|...|.|...|.|.######
###########################--+----+..-+-+---+-+-######
###########################..|....|...|.|...|.|.######
###########################..|....|...|.|...|.|.######
###########################..|....|...|.....|.|.######
###########################..|....|.........|.|.######
###########################..|....|...........|.######
###########################.......|.....|.....|..=####
###########################.......|.....|.....|.######
###########################.......|.....|.....|.######
###########################..|....|.....|.....|.######
############################.|....|.|...|.....|#######
##############################....|.|...|....#########
##################################H#H###H#############
###############################=##=#=#=#=##=##########
######################################################
######################################################
######################################################
(4,9),(4,10)|(4,11),(4,12)|(4,13),(4,14)|(4,15),(4,16)|(6,10),(6,11)|(6,12),(6,13)|(6,14),(6,15)|(8,0),(8,7)|(13,17),(13,18)|(14,17),(14,18)|(16,15),(16,16)|(18,14),(18,15)|(20,14),(20,15)|(21,15),(21,16)|(27,18),(27,28)|(28,28),(28,29)|(30,29),(30,30)|(31,31),(31,32)|(32,31),(32,32)|(34,30),(34,32)|(35,30),(35,32)|(36,30),(36,32)|(37,30),(37,32)|(38,31),(38,32)|(39,31),(39,32)|(40,30),(40,32)|(41,30),(41,32)|(43,31),(43,32)|(44,31),(44,32)|(45,29),(45,30)|(47,28),(47,29)|(48,7),(48,14)|(48,15),(48,24)|(48,25),(48,28)|(50,14),(50,15)|(50,24),(50,25)|(52,5),(52,6)|(53,4),(53,5)|
(53,4),(54,4)|(52,5),(53,5)|(49,6),(52,6)|(4,9),(6,9)|(4,10),(6,10)|(4,11),(6,11)|(4,12),(6,12)|(4,13),(6,13)|(4,14),(6,14)|(18,14),(20,14)|(48,14),(50,14)|(4,15),(6,15)|(16,15),(18,15)|(20,15),(21,15)|(48,15),(50,15)|(4,16),(16,16)|(21,16),(25,16)|(13,17),(14,17)|(13,18),(14,18)|(48,24),(50,24)|(48,25),(50,25)|(27,28),(28,28)|(47,28),(48,28)|(28,29),(30,29)|(45,29),(47,29)|(30,30),(34,30)|(35,30),(36,30)|(37,30),(40,30)|(41,30),(45,30)|(31,31),(32,31)|(38,31),(39,31)|(43,31),(44,31)|(31,32),(32,32)|(34,32),(35,32)|(36,32),(37,32)|(38,32),(39,32)|(40,32),(41,32)|(43,32),(44,32)|
(25,16),(27,18)|
(6,9),(8,7)|(48,7),(49,6)|
(29.5,13),(29.5,24)|(29.5,27),(29.5,29)|(34.5,15),(34.5,30)|(36.5,28),(36.5,30)|(38.5,17),(38.5,22)|(40.5,8),(40.5,21)|(40.5,24),(40.5,30)|(44.5,13),(44.5,23)|(46.5,17),(46.5,29)|
(27,18.5),(37,18.5)|
end file : SU_A10