Pièce : SU_A53
taille : 50x38
##########..............................##########
##########..............................##########
############............................##########
######################..................##########
##########......####-----...............##########
######################..................##########
##########.|............................##########
#####/-----+-------------+-..........-------/#####
###=.......|.............|....................=###
##########.|.............|..............##########
#######.###H###--................--#######.#######
#######.##.|.##....................##...##########
#######.##.|.|......................|...##########
#######.##.|.|......................|...##########
#######.##...|...........|..........|...##.#######
#######.##...|...........|..........|...##.#######
#######.##...|...........|..........|...##.#######
######/................--+----------+-------/#####
###=.....................|....................=###
##########...............|............############
##########...##-----.....|..............##=#######
##########...##..........|..............##########
##########...............|.........-----##########
##########..............................##########
###############---......................##########
##########...##.........................##########
##########...|....................-###############
##########...|.....................##...##########
########=....|......................|...##########
##########...|......................|...##########
########=....|......................|....=########
##########...|......................|...##########
##############/..................../##############
###############/../###/..../###/../###############
####################=########=####################
##################################################
##################################################
##################################################
3,8|3,9|3,18|3,19|7,10|8,10|8,17|8,28|8,29|8,30|8,31|10,0|10,2|10,4|10,5|10,6|10,9|10,10|10,11|10,17|10,19|10,24|10,25|10,28|10,29|10,30|10,31|10,32|12,2|12,3|13,11|13,20|13,22|13,25|15,12|15,22|15,26|16,4|16,5|20,34|20,35|21,34|21,35|22,3|22,6|29,34|29,35|30,34|30,35|35,12|35,28|37,11|37,27|38,19|38,20|40,0|40,9|40,10|40,11|40,20|40,26|40,27|40,30|40,31|40,32|42,10|42,11|42,14|42,20|42,21|42,30|42,31|43,10|43,11|43,14|43,20|43,21|47,8|47,9|47,18|47,19|
(3,8),(3,9)|(3,18),(3,19)|(7,10),(8,10)|(8,17),(8,28)|(8,29),(8,30)|(8,31),(10,0)|(10,2),(10,4)|(10,5),(10,6)|(10,9),(10,10)|(10,11),(10,17)|(10,19),(10,24)|(10,25),(10,28)|(10,29),(10,30)|(10,31),(10,32)|(12,2),(12,3)|(13,11),(13,20)|(13,22),(13,25)|(15,12),(15,22)|(15,26),(16,4)|(16,5),(20,34)|(20,35),(21,34)|(21,35),(22,3)|(22,6),(29,34)|(29,35),(30,34)|(30,35),(35,12)|(35,28),(37,11)|(37,27),(38,19)|(38,20),(40,0)|(40,9),(40,10)|(40,11),(40,20)|(40,26),(40,27)|(40,30),(40,31)|(40,32),(42,10)|(42,11),(42,14)|(42,20),(42,21)|(42,30),(42,31)|(43,10),(43,11)|(43,14),(43,20)|(43,21),(47,8)|(47,9),(47,18)|
(10,0),(40,0)|(10,2),(12,2)|(12,3),(22,3)|(10,4),(16,4)|(10,5),(16,5)|(10,6),(22,6)|(3,8),(47,8)|(3,9),(10,9)|(40,9),(47,9)|(7,10),(8,10)|(10,10),(40,10)|(42,10),(43,10)|(10,11),(13,11)|(37,11),(40,11)|(42,11),(43,11)|(15,12),(35,12)|(42,14),(43,14)|(8,17),(10,17)|(3,18),(47,18)|(3,19),(10,19)|(38,19),(47,19)|(13,20),(38,20)|(40,20),(42,20)|(43,20),(42,21)|(43,21),(13,22)|(15,22),(10,24)|(10,25),(13,25)|(15,26),(40,26)|(37,27),(40,27)|(8,28),(10,28)|(35,28),(8,29)|(10,29),(8,30)|(10,30),(40,30)|(42,30),(8,31)|(10,31),(40,31)|(42,31),(10,32)|(40,32),(20,34)|(21,34),(29,34)|(30,34),(20,35)|(21,35),(29,35)|