Pièce : SU_A07
taille : 54x35
#####............................................#####
#####............................................#####
#####............................................#####
#####.........................................../#####
#####...........................................######
#####............................................=####
#####...........................................######
#####............................................=####
#####....................................|...|..######
#####....................................||.||..######
#####....................................+###+..######
#####...................................-+###+-.######
#####/...................................+###+..######
######...................................||.||..######
######...................................|...|..######
######...................................|...|..######
######....|...|..........................|...|..######
######....||.||..........................|...|.#######
######....+###+..........................|...|########
######...-+###+-.....|...|............./##############
######....+###+......||.||............/####.##########
######....||.||......+###+............#####.##########
######....|...|.....-+###+-............=###......=####
######....|...|......+###+......./###########.########
####=.....|...|......||.||....../############.########
######....|...#......|...|......#############.########
####=.....|.####.....|...|.......=###########.########
#############################################.########
########.########.##########.################.########
########..................##....................######
#################.........##.######..............=####
####################/........####=........../#########
######################################################
######################################################
######################################################
4,24|4,25|4,26|4,27|5,0|6,24|6,25|6,26|8,28|8,30|9,28|9,29|12,26|12,27|14,26|15,26|16,26|16,27|17,28|17,29|17,30|17,31|18,28|18,29|26,29|26,31|28,28|28,31|29,28|29,29|29,30|29,32|32,26|33,31|33,32|34,26|34,27|35,30|35,31|38,22|40,22|40,23|43,20|43,23|44,20|44,22|45,23|45,29|46,23|46,29|47,17|47,18|48,5|48,6|48,7|48,8|48,17|48,29|48,30|49,0|50,5|50,6|50,7|50,8|50,22|50,23|50,30|50,31|
(4,24),(4,25)|(4,26),(4,27)|(5,0),(6,24)|(6,25),(6,26)|(8,28),(8,30)|(9,28),(9,29)|(12,26),(12,27)|(14,26),(15,26)|(16,26),(16,27)|(17,28),(17,29)|(17,30),(17,31)|(18,28),(18,29)|(26,29),(26,31)|(28,28),(28,31)|(29,28),(29,29)|(29,30),(29,32)|(32,26),(33,31)|(33,32),(34,26)|(34,27),(35,30)|(35,31),(38,22)|(40,22),(40,23)|(43,20),(43,23)|(44,20),(44,22)|(45,23),(45,29)|(46,23),(46,29)|(47,17),(47,18)|(48,5),(48,6)|(48,7),(48,8)|(48,17),(48,29)|(48,30),(49,0)|(50,5),(50,6)|(50,7),(50,8)|(50,22),(50,23)|(50,30),(50,31)|
(5,0),(49,0)|(48,5),(50,5)|(48,6),(50,6)|(48,7),(50,7)|(48,8),(50,8)|(47,17),(48,17)|(47,18),(43,20)|(44,20),(38,22)|(40,22),(44,22)|(50,22),(40,23)|(43,23),(45,23)|(46,23),(50,23)|(4,24),(6,24)|(4,25),(6,25)|(4,26),(6,26)|(12,26),(14,26)|(15,26),(16,26)|(32,26),(34,26)|(4,27),(12,27)|(16,27),(34,27)|(8,28),(9,28)|(17,28),(18,28)|(28,28),(29,28)|(9,29),(17,29)|(18,29),(26,29)|(29,29),(45,29)|(46,29),(48,29)|(8,30),(17,30)|(29,30),(35,30)|(48,30),(50,30)|(17,31),(26,31)|(28,31),(33,31)|(35,31),(50,31)|(29,32),(33,32)|