Piece : SU_A41
54x35
255x-222
######################################################
######################################################
##############################.......#################
#############################.........################
######################################################
###################=......|..............|.....#######
#########################.|.###########..|.###########
######################....|..............|.###########
#####################/....|..............|../#########
#####################.....|..............|....########
#####################.....|..............|.....#######
####################......|..............|......=#####
####################......|..............|.....#######
####################......|..............|.../########
#####################.....|..............|../#########
######################....|..............|..##########
######################/...|..............|..##########
#######################...|..............|../#########
######################/...|.....####.....|..../#######
###########/.../#####/....|.....####.....|.....#######
########/.................|.....####.....|.....#######
########..................|.....####.....|...../######
#######/..................|.....####.....|.......#####
#######...................|.....####.....|.......#####
#######...................|....#####.....|.......#####
#####=....................|.....#####....|.......#####
#######...................|....######....|....../#####
#########/........####..#####...####.....|......######
#######################################..|.###########
#########...........#######.....####.....|.....=######
######################################################
######################################################
######################################################
######################################################
######################################################
(5,25),(5,26)|(7,21.5),(7,23)|(7,25),(7,26)|(8,21),(8,22)|(9,20),(9,27)|(9,27.5),(9,29)|(18,27),(18,28)|(19,5),(19,6)|(20,9.5),(20,11)|(20,14),(20,29)|(21,9),(21,11)|(21,14),(21,15)|(21,17.5),(21,20)|(22,7),(22,8)|(22,15),(22,16)|(22,27),(22,28)|(23,17),(23,18)|(24,27),(24,28)|(25,6),(25,7)|(27,29),(27,30)|(28,6),(28,7)|(29,3),(29,4)|(29,27),(29,28)|(30,2),(30,3)|(31,24),(31,25)|(31,26),(31,27)|(32,18),(32,24)|(32,25),(32,26)|(32,27),(32,28)|(32,29),(32,30)|(36,18),(36,25)|(36,27),(36,28)|(36,29),(36,30)|(37,2),(37,3)|(37,25),(37,27)|(38,3),(38,4)|(39,6),(39,7)|(39,28),(39,29)|(43,6),(43,8)|(43,28),(43,29)|(44,8),(44,15)|(46,9),(46,10)|(47,5),(47,6)|(47,10),(47,11)|(47,12),(47,13)|(47,18.5),(47,19)|(48,27),(48,28)|(48,29),(48,30)|(49,11),(49,12)|(49,22),(49,26)|
(30,2),(37,2)|(29,3),(30,3)|(37,3),(38,3)|(29,4),(38,4)|(19,5),(47,5)|(19,6),(25,6)|(28,6),(39,6)|(43,6),(47,6)|(22,7),(25,7)|(28,7),(39,7)|(43,8),(44,8)|(21,9),(45,9)|(46,10),(47,10)|(20,11),(21,11)|(47,11),(49,11)|(47,12),(49,12)|(46,13),(47,13)|(20,14),(21,14)|(21,15),(22,15)|(32,18),(36,18)|(45,18),(46,18)|(9.5,19),(12,19)|(15,19),(47,19)|(9,20),(11,20)|(16,20),(21,20)|(8,21),(47,21)|(48,22),(49,22)|(31,24),(32,24)|(5,25),(7,25)|(31,25),(32,25)|(36,25),(37,25)|(5,26),(7,26)|(31,26),(32,26)|(7,27),(9,27)|(18,27),(22,27)|(24,27),(29,27)|(31,27),(32,27)|(36,27),(37,27)|(9.5,28),(10,28)|(18,28),(22,28)|(24,28),(29,28)|(32,28),(36,28)|(39,28),(43,28)|(9,29),(20,29)|(27,29),(32,29)|(36,29),(39,29)|(43,29),(48,29)|(9,30),(20,30)|(27,30),(32,30)|(36,30),(48,30)|
(9,27),(10,28)|(15,19),(16,20)|(22,16),(23,17)|(44,8),(45,9)|(44,17),(45,18)|(46,18),(47,19)|(47,21),(48,22)|
(7,23),(8,22)|(7,23),(21,9)|(7,23),(22,8)|(8,21),(9,20)|(11,20),(12,19)|(21,20),(23,18)|(44,15),(46,13)|(48,27),(49,26)|
(26.5,5),(26.5,27)|(41.5,5),(41.5,30)|
None|
end file : SU_A41