Pièce : SU_B11
taille : 104x35
.........................................................................................##......##.....
.........................................................................................##......##.....
.................................................................................##......##......##....#
................................................................................#####....##.#######.####
............................................................................../#########################
...........................|.........................|......................./########=#################
...........................||........................||...................../###########################
...........................||........................||.....................############################
...........................||........................||....................#############################
...........................||........................||.....................############################
.......................####||........................||.....................############################
....................../#######/................./#######/...................############################
......................#########.................#########..................#############################
......................##########...............###########..................############################
..............|.......##=###=##.................##=###=##...................############################
..............|.......##.###.##................###.###.###....................................##########
..............|.......................|........................................................=########
..............|.......................|.......................................................##########
..............|.......................|........................................................=########
..............|.......................|.......................................................##########
..............|.......#########.......|.........#########......................................=########
.......|......|.......#########.......#.........#########........|............................##########
.......|......|......./#######/.......#........./#######/........|.............................=########
.......|......|........|.....|........#..........|.....|.........|............................##########
.......|......|........|.....|........|..........|.....|.........|.........#############################
.......|......#..............|........|..........|.....|.........|..........############################
.......|......#..............|........|..........|.....|.........|..........############################
.......|......#........|.....|........|..........|.....|.........|..........############################
.......|......#........|.....|........|.........###....|.........|........##############################
.......|......#../#################/..|..../#################/...|......################################
...../##################################################################################################
..../#####=###########################=##########################=######################################
.../####################################################################################################
...#####################################################################################################
...#####################################################################################################
(3,35),(10,31)|(10,32),(11,31)|(11,32),(14,30)|(15,30),(22,16)|(22,20),(23,10)|(24,14),(24,16)|(25,14),(25,16)|(28,14),(28,16)|(29,14),(29,16)|(31,13),(31,14)|(31,16),(31,20)|(32,13),(32,14)|(38,31),(38,32)|(39,31),(39,32)|(47,13),(47,14)|(47,15),(47,16)|(48,13),(48,14)|(48,15),(48,20)|(48,28),(48,29)|(50,14),(50,16)|(51,14),(51,16)|(51,28),(51,29)|(54,14),(54,16)|(55,14),(55,16)|(57,13),(57,14)|(57,15),(57,20)|(58,13),(58,14)|(58,15),(58,16)|(65,31),(65,32)|(66,31),(66,32)|(72,29),(72,30)|(74,28),(74,29)|(75,8),(75,9)|(75,12),(75,13)|(75,24),(75,25)|(76,8),(76,9)|(76,12),(76,13)|(76,15),(76,25)|(76,28),(80,3)|(80,4),(81,2)|(81,3),(83,2)|(83,3),(85,3)|(85,4),(86,5)|(86,6),(87,5)|(87,6),(89,0)|(89,4),(91,0)|(91,4),(92,3)|(92,4),(94,15)|(94,16),(94,17)|(94,18),(94,19)|(94,20),(94,21)|(94,22),(94,23)|(94,24),(96,16)|(96,17),(96,18)|(96,19),(96,20)|(96,21),(96,22)|(96,23),(97,0)|(97,3),(99,0)|(99,4),(100,3)|(100,4),(103,2)|(103,3),(104,2)|
(89,0),(91,0)|(97,0),(99,0)|(81,2),(83,2)|(103,2),(104,2)|(80,3),(81,3)|(83,3),(85,3)|(92,3),(97,3)|(100,3),(103,3)|(80,4),(85,4)|(89,4),(91,4)|(92,4),(99,4)|(100,4),(86,5)|(87,5),(86,6)|(87,6),(75,8)|(76,8),(75,9)|(76,9),(23,10)|(75,12),(76,12)|(31,13),(32,13)|(47,13),(48,13)|(57,13),(58,13)|(75,13),(76,13)|(24,14),(25,14)|(28,14),(29,14)|(31,14),(32,14)|(47,14),(48,14)|(50,14),(51,14)|(54,14),(55,14)|(57,14),(58,14)|(47,15),(48,15)|(57,15),(58,15)|(76,15),(94,15)|(22,16),(24,16)|(25,16),(28,16)|(29,16),(31,16)|(47,16),(50,16)|(51,16),(54,16)|(55,16),(58,16)|(94,16),(96,16)|(94,17),(96,17)|(94,18),(96,18)|(94,19),(96,19)|(22,20),(31,20)|(48,20),(57,20)|(94,20),(96,20)|(94,21),(96,21)|(94,22),(96,22)|(94,23),(96,23)|(75,24),(94,24)|(75,25),(76,25)|(48,28),(51,28)|(74,28),(76,28)|(48,29),(51,29)|(72,29),(74,29)|(14,30),(15,30)|(72,30),(10,31)|(11,31),(38,31)|(39,31),(65,31)|(66,31),(10,32)|(11,32),(38,32)|(39,32),(65,32)|(66,32),(3,35)|