Pièce : SU_B11
taille : 104x35
.........................................................................................##......##.....
.........................................................................................##......##.....
.................................................................................##......##......##....#
................................................................................#####....##.#######.####
............................................................................../#########################
...........................|.........................|......................./########=#################
...........................||........................||...................../###########################
...........................||........................||.....................############################
...........................||........................||....................#############################
...........................||........................||.....................############################
.......................####||........................||.....................############################
....................../#######/................./#######/...................############################
......................#########.................#########..................#############################
......................##########...............###########..................############################
..............|.......##=###=##.................##=###=##...................############################
..............|.......##.###.##................###.###.###....................................##########
..............|.......................|........................................................=########
..............|.......................|.......................................................##########
..............|.......................|........................................................=########
..............|.......................|.......................................................##########
..............|.......#########.......|.........#########......................................=########
.......|......|.......#########.......#.........#########........|............................##########
.......|......|......./#######/.......#........./#######/........|.............................=########
.......|......|........|.....|........#..........|.....|.........|............................##########
.......|......|........|.....|........|..........|.....|.........|.........#############################
.......|......#..............|........|..........|.....|.........|..........############################
.......|......#..............|........|..........|.....|.........|..........############################
.......|......#........|.....|........|..........|.....|.........|..........############################
.......|......#........|.....|........|.........###....|.........|........##############################
.......|......#../#################/..|..../#################/...|......################################
...../##################################################################################################
..../#####=###########################=##########################=######################################
.../####################################################################################################
...#####################################################################################################
...#####################################################################################################
83,2|103,2|80,3|81,3|83,3|85,3|92,3|97,3|100,3|103,3|79,4|80,4|85,4|89,4|91,4|92,4|99,4|100,4|76,7|75,9|75,8|76,9|76,8|23,10|23,11|22,12|31,12|30,11|49,11|48,12|57,12|56,11|75,13|75,12|76,13|76,12|31,14|31,13|32,14|32,13|47,14|47,13|48,14|48,13|57,14|57,13|58,14|58,13|76,15|94,15|22,16|24,16|25,16|28,16|29,16|31,16|47,16|47,15|48,15|50,16|51,16|54,16|55,16|57,15|58,16|58,15|94,16|94,18|94,17|94,20|94,19|22,20|31,20|48,20|57,20|94,22|94,21|23,23|22,22|31,22|30,23|49,23|48,22|57,22|56,23|94,23|75,25|75,24|76,25|94,24|48,28|51,28|74,28|76,28|18,29|17,30|36,30|35,29|44,29|43,30|48,29|51,29|62,30|61,29|72,29|74,29|6,30|15,30|14,30|72,30|3,33|