Pièce : SU_C04
taille : 155x35
##################################################################/.............###########################################################################
############/../##################################################.............../#########################################################################
############....../##############################################/................#########################################################################
###########/.......############################################/................../########################################################################
#########...........##########################################.....................########################################################################
############.......###############################################..............###########################################################################
#####=..................##############################...#####.......................#####......###########################################################
###############.....################################################..........#############################################################################
############...........############################................................../#####################################################################
##########/............/##########################....................................../##################################################################
##########..............#########################/......................................../################################################################
###########/............############/..../######/..........................................################################################################
############/...........##########........./###.............................................###############################################################
#############.........../#######/.........................................................../##############################################################
#############.............#####............................................................../##/....#########################################/.../########
############/........................................................................................../###################################......../#######
############............................................................................................./################################/.........#######
##########/.............................................................................................../#####/................/########..........#######
##########........................................................................................................................../####/..........#######
##########...........................................................................................................................................######
#########/.......................................................####............####................................................................######
#########........................................................####............####.................................................................#####
#########........................................................####............####.................................................................#####
#########........................................................####............####..................................................................=###
#########........................................................####............####.................................................................#####
##########.......................................................####............####.............................................................../######
##########.................................../#######/...........####............####.......###.../####/.............................###.........##########
##########/............................../###############........####............####.......###./#########....###...................#######################
############............#########/.....####################/................................###############################################################
##############........#####################################################################################################################################
################/.../#################################..........######..........######..........###########......##########################################
###########################################################################################################################################################
###########################################################################################################################################################
###########################################################################################################################################################
###########################################################################################################################################################
(5,6),(5,7)|(9,4),(9,5)|(10,11),(10,25)|(12,5),(12,6)|(12,8),(12,9)|(12,17),(12,28)|(14,29),(14,30)|(15,7),(15,8)|(19,4),(19,5)|(20,4),(20,5)|(20,7),(20,8)|(22,29),(22,30)|(24,6),(24,7)|(24,28),(24,29)|(26,14),(26,15)|(31,14),(31,15)|(34,12),(34,13)|(39,28),(39,29)|(47,12),(47,13)|(51,8),(51,9)|(54,6),(54,7)|(54,30),(54,31)|(57,6),(57,7)|(57,27),(57,28)|(62,4),(62,5)|(62,6),(62,7)|(64,30),(64,31)|(65,20),(65,28)|(66,5),(66,6)|(68,7),(68,8)|(69,20),(69,28)|(70,30),(70,31)|(78,7),(78,8)|(80,0),(80,1)|(80,5),(80,6)|(80,30),(80,31)|(81,20),(81,28)|(85,6),(85,7)|(85,20),(85,28)|(86,30),(86,31)|(90,6),(90,7)|(92,12),(92,26)|(95,26),(95,28)|(96,6),(96,7)|(96,30),(96,31)|(101,14),(101,15)|(106,27),(106,28)|(107,30),(107,31)|(110,27),(110,28)|(113,27),(113,28)|(113,30),(113,31)|(132,27),(132,28)|(133,26),(133,27)|(136,26),(136,27)|(145,26),(145,27)|(149,19),(149,21)|(150,21),(150,23)|(150,24),(150,25)|(152,23),(152,24)|
(9,9),(19,4)|(20,20),(62,4)|(9,9),(12,5)|(19,19),(20,5)|(62,62),(66,5)|(80,80),(83,5)|(5,5),(12,6)|(19,19),(24,6)|(54,54),(57,6)|(62,62),(66,6)|(80,80),(85,6)|(90,90),(96,6)|(5,5),(15,7)|(20,20),(24,7)|(54,54),(57,7)|(62,62),(68,7)|(78,78),(85,7)|(90,90),(96,7)|(12,12),(15,8)|(20,20),(23,8)|(51,51),(68,8)|(12,12),(50,9)|(34,34),(47,12)|(91,91),(92,12)|(34,34),(47,13)|(26,26),(31,14)|(26,26),(31,15)|(101,101),(139,15)|(148,148),(149,19)|(65,65),(69,20)|(81,81),(85,20)|(149,149),(150,21)|(150,150),(152,23)|(150,150),(152,24)|(9,9),(10,25)|(92,92),(95,26)|(133,133),(136,26)|(57,57),(106,27)|(110,110),(113,27)|(132,132),(133,27)|(136,136),(145,27)|(12,12),(24,28)|(39,39),(57,28)|(65,65),(69,28)|(81,81),(85,28)|(95,95),(106,28)|(110,110),(113,28)|(12,12),(14,29)|(22,22),(24,29)|(39,39),(92,29)|(14,14),(22,30)|(54,54),(64,30)|(70,70),(80,30)|(86,86),(96,30)|(107,107),(113,30)|(54,54),(64,31)|(70,70),(80,31)|(86,86),(96,31)|(107,107),(113,31)|
(10,27),(11,28)|(11,11),(13,13)|(15,1),(16,2)|(15,1),(23,9)|(15,1),(24,10)|(16,30),(17,31)|(18,2),(19,3)|(24,13),(25,14)|(33,28),(34,29)|(41,11),(42,12)|(43,12),(44,13)|(43,12),(59,28)|(43,12),(60,29)|(53,26),(54,27)|(81,1),(82,2)|(81,1),(90,10)|(81,1),(91,11)|(82,3),(83,4)|(82,3),(88,9)|(82,3),(89,10)|(82,3),(92,13)|(82,3),(94,15)|(85,8),(86,9)|(85,8),(103,26)|(85,8),(104,27)|(103,15),(104,16)|(105,16),(107,18)|(129,17),(130,18)|(132,18),(133,19)|(146,14),(148,16)|
(9,21),(10,20)|(10,10),(11,9)|(10,18),(11,17)|(10,18),(12,16)|(10,18),(13,15)|(11,4),(12,3)|(12,2),(13,1)|(20,31),(21,30)|(32,14),(33,13)|(36,12),(37,11)|(41,28),(42,27)|(45,27),(46,26)|(48,12),(50,10)|(63,4),(64,3)|(65,3),(66,2)|(96,15),(97,14)|(96,28),(97,27)|(98,27),(99,26)|(112,18),(113,17)|(137,19),(138,18)|(138,17),(139,16)|(142,15),(143,14)|(148,26),(149,25)|


end file : SU_C04