Pièce : GATE_DS_GW
taille : 48x35
########.....##...............#.........########
########.....##...............#.........########
########.....##...............#.################
########/....##...............#.#....../########
#########/...########......####.#...../#########
##########/..########......######..../##########
###########/.......##......###....../###########
################################################
################################################
################################################
################################################
##################...######...##################
##################...######...##################
#################/.../####/.../#################
#################.....####.....#################
###########=#####.....####.....#####=###########
###########|########################|###########
#########/.|./##/...../##/...../##/.|./#########
####.......|........................|.......####
##=........|........................|........=##
####.......|........................|.......####
####.......|........................|.......####
##=........|........................|........=##
####.......|........................|.......####
####.......|........................|....##.####
##=........|........................|...########
####.......|........................|..#########
#########/.|./##/...../##/...../##/.|.##########
###########H########################H###########
###########=#####.....####.....#####=###########
#################.....####.....#################
#################.....####.....#################
#################.....####.....#################
#################.....####.....#################
#################.....####.....#################
(2,19),(2,20)|(2,22),(2,23)|(2,25),(2,26)|(4,18),(4,19)|(4,20),(4,22)|(4,23),(4,25)|(4,26),(4,27)|(8,0),(11,15)|(11,30),(12,15)|(12,30),(13,0)|(13,6),(15,0)|(15,4),(17,16)|(17,29),(17,35)|(18,11),(19,6)|(19,7),(21,4)|(21,7),(21,11)|(22,16),(22,29)|(22,35),(26,16)|(26,29),(26,35)|(27,4),(27,7)|(27,11),(30,0)|(30,4),(30,6)|(30,7),(30,11)|(31,0),(31,5)|(31,16),(31,29)|(31,35),(32,2)|(32,5),(33,3)|(33,6),(36,15)|(36,30),(37,15)|(37,30),(38,27)|(38,28),(39,26)|(39,27),(40,0)|(40,2),(40,25)|(40,26),(41,24)|(41,25),(43,24)|(43,25),(44,18)|(44,19),(44,20)|(44,22),(44,23)|(44,25),(46,19)|(46,20),(46,22)|
(8,0),(13,0)|(15,0),(30,0)|(31,0),(40,0)|(32,2),(40,2)|(33,3),(15,4)|(21,4),(27,4)|(30,4),(31,5)|(32,5),(13,6)|(19,6),(30,6)|(33,6),(19,7)|(21,7),(27,7)|(30,7),(18,11)|(21,11),(27,11)|(30,11),(11,15)|(12,15),(36,15)|(37,15),(17,16)|(22,16),(26,16)|(31,16),(4,18)|(44,18),(2,19)|(4,19),(44,19)|(46,19),(2,20)|(4,20),(44,20)|(46,20),(2,22)|(4,22),(44,22)|(46,22),(2,23)|(4,23),(44,23)|(46,23),(41,24)|(43,24),(2,25)|(4,25),(40,25)|(41,25),(43,25)|(44,25),(2,26)|(4,26),(39,26)|(40,26),(4,27)|(38,27),(39,27)|(38,28),(17,29)|(22,29),(26,29)|(31,29),(11,30)|(12,30),(36,30)|(37,30),(17,35)|(22,35),(26,35)|