Pièce : DS_A10
taille : 48x35
################################################
################################################
##=..###########################################
####.######################################=####
####.######################################|####
####.#####################################.|.###
####.#####################################.|.###
####.#####################################.|.###
####.#####################################.|.###
####.#######........########........######.|.###
####.#######.######.########.######.######.|.###
####+#######+######+########+######+######.|.###
##/.|./#####|####/.|./####/.|./####|#####/.|./##
##..|..####.|.###..|..####..|..###.|.####..|..##
##..|..####.|.###..|..####..|..###.|.####..|..##
##.....####...###.....####.....###...####.....##
##.....####...###.....####.....###...####.....##
##.....####...###.....####.....###...####.....##
##.....####...###.....####.....###...####.....##
##.....####...###.....####.....###...####.....##
##.....####...###.....####.....###...####.....##
##.....####...###.....####.....###...####.....##
##.....####...###.....####.....###...####.....##
##.....####...###.....####.....###...####.....##
##/.../####...###.....####.....###...####/.../##
####.#######.####.....####.....####.#######.####
####.#######.####.....####.....####.#######.####
####.........####/.../####/.../####.#######.####
###################.########.######.........####
###################.########.###################
###################..........###################
################################################
################################################
################################################
################################################
(2,2),(2,3)|(4,3),(4,12)|(4,25),(4,28)|(5,2),(5,12)|(5,25),(5,27)|(11,13),(11,25)|(12,9),(12,13)|(12,25),(12,27)|(13,10),(13,13)|(13,25),(13,28)|(14,13),(14,25)|(19,10),(19,12)|(19,28),(19,31)|(20,9),(20,12)|(20,28),(20,30)|(28,9),(28,12)|(28,28),(28,30)|(29,10),(29,12)|(29,28),(29,31)|(34,13),(34,25)|(35,10),(35,13)|(35,25),(35,29)|(36,9),(36,13)|(36,25),(36,28)|(37,13),(37,25)|(43,3),(43,5)|(43,25),(43,28)|(44,3),(44,5)|(44,25),(44,29)|
(2,2),(5,2)|(2,2),(4,3)|(43,43),(44,3)|(42,42),(43,5)|(44,44),(45,5)|(12,12),(20,9)|(28,28),(36,9)|(13,13),(19,10)|(29,29),(35,10)|(4,4),(5,12)|(19,19),(20,12)|(28,28),(29,12)|(11,11),(12,13)|(13,13),(14,13)|(34,34),(35,13)|(36,36),(37,13)|(4,4),(5,25)|(11,11),(12,25)|(13,13),(14,25)|(34,34),(35,25)|(36,36),(37,25)|(43,43),(44,25)|(5,5),(12,27)|(4,4),(13,28)|(19,19),(20,28)|(28,28),(29,28)|(36,36),(43,28)|(35,35),(44,29)|(20,20),(28,30)|(19,19),(29,31)|
(2,24),(3,25)|(6,12),(7,13)|(17,27),(18,28)|(21,12),(22,13)|(26,27),(27,28)|(30,12),(31,13)|(41,24),(42,25)|(45,12),(46,13)|
(2,13),(3,12)|(6,25),(7,24)|(17,13),(18,12)|(21,28),(22,27)|(26,13),(27,12)|(30,28),(31,27)|(41,13),(42,12)|(45,25),(46,24)|
(4.5,15),(12.5,15)|(19.5,15),(28.5,15)|(35.5,15),(43.5,4)|

end file : DS_A10