Pièce : DS_A06
taille : 54x35
######################################################
######################################################
######################################################
######################################################
######################################################
######################################################
#####################................###........######
#####################................#################
######...............................#################
######..........................................######
######................./#/....../#/.............######
####=........./#/......###......###..............=####
######........###....../#/....../#/.............######
####=........./#/................................=####
######..........................................######
###########...................................########
#########.....................................########
###########..............................#############
#######=.................................#############
############||#.........................-#############
##########/...|..........................#############
###########/..|........###......###......####..#######
############/.|........###......#=#.....-####...######
#############/|......../#/......###......####...######
##############/..........................####...######
###############/........................-####...######
################/........................####...######
#################/...............|.......####...######
##################/.....|........|.......####...######
###################/....|........|.......####...######
######################..|........|......######.#######
######################..|........|.....###############
########################H#############################
########################=#############################
######################################################
(4,11),(4,12)|(4,13),(4,14)|(6,8),(6,11)|(6,12),(6,13)|(6,14),(6,15)|(7,18),(7,19)|(9,16),(9,17)|(11,15),(11,16)|(11,17),(11,18)|(12,19),(12,20)|(14,19),(14,20)|(15,11),(15,14)|(15,19),(15,20)|(16,11),(16,14)|(21,6),(21,8)|(22,30),(22,32)|(24,10),(24,13)|(24,24),(24,32)|(25,10),(25,13)|(25,24),(25,32)|(32,21),(32,24)|(33,10),(33,13)|(33,22),(33,23)|(34,10),(34,13)|(34,22),(34,23)|(35,21),(35,24)|(37,6),(37,9)|(39,31),(39,32)|(40,6),(40,7)|(40,30),(40,31)|(41,17),(41,30)|(45,21),(45,30)|(46,15),(46,17)|(46,30),(46,31)|(47,21),(47,22)|(47,30),(47,31)|(48,6),(48,7)|(48,9),(48,11)|(48,12),(48,13)|(48,14),(48,15)|(48,22),(48,30)|(50,11),(50,12)|(50,13),(50,14)|
(21,6),(37,6)|(40,6),(48,6)|(40,7),(48,7)|(6,8),(21,8)|(37,9),(48,9)|(24,10),(25,10)|(33,10),(34,10)|(4,11),(6,11)|(15,11),(16,11)|(48,11),(50,11)|(4,12),(6,12)|(48,12),(50,12)|(4,13),(6,13)|(24,13),(25,13)|(33,13),(34,13)|(48,13),(50,13)|(4,14),(6,14)|(15,14),(16,14)|(48,14),(50,14)|(6,15),(11,15)|(46,15),(48,15)|(9,16),(11,16)|(9,17),(11,17)|(41,17),(46,17)|(7,18),(11,18)|(7,19),(12,19)|(14,19),(15,19)|(12,20),(14,20)|(23,21),(26,21)|(32,21),(35,21)|(45,21),(47,21)|(33,22),(34,22)|(47,22),(48,22)|(33,23),(34,23)|(24,24),(25,24)|(32,24),(35,24)|(22,30),(40,30)|(41,30),(45,30)|(46,30),(47,30)|(39,31),(40,31)|(46,31),(47,31)|(22,32),(24,32)|(25,32),(39,32)|(24,34),(25,34)|
(14,13),(15,14)|(16,11),(17,12)|(23,12),(24,13)|(23,23),(24,24)|(25,10),(26,11)|(32,12),(33,13)|(34,10),(35,11)|
(14,12),(15,11)|(16,14),(17,13)|(23,11),(24,10)|(25,13),(26,12)|(25,24),(26,23)|(32,11),(33,10)|(34,13),(35,12)|
(12.5,19),(12.5,20)|(13.5,19),(13.5,20)|(14.5,20),(14.5,24)|(24.5,28),(24.5,32)|(33.5,27),(33.5,32)|
(40,19.5),(40,22.5)|(40,25.5),(41,19.5)|(41,22.5),(41,25.5)|
end file : DS_A06