Pièce : DS_A13
taille : 48x35
################################################
################################################
##=...#####...........####################...=##
#####+#####+#########.####################+#####
####.|.###.|.########.##################/.|./###
####.|.###.|.########.##################..|..###
####.|.###.|.########.##################..|..###
####.|.###.|.########.####.......#######..|..###
####...###...########.####.#####.#######.....###
####...###...########.####.#####.#######.....###
####...###...######/......../###.#######.....###
####...###...######..........###.#######.....###
####...###...######----------###.#######.....###
####...###...######..........###.#######/.../###
####...###...######..........###.#########.#####
####...###...######----------###.#########.#####
####...###...######..........###.#########.#####
####...###...######..........###.#########.#####
####...###...######..........###.#########...###
####...###...######..........###.###########.###
####...###...######..........###.###########.###
#####.#####.#######..........###......###....###
#####.#####.#######..........########.###.######
#####..###..#######..........########.###.######
######.###.########..........########.###.######
####/...#.../######..........######/...#.../####
###/....#..../#####..........#####/....#..../###
###...........#####/......../#####...........###
###...........####################...........###
###.....#.....########=##=########.....#.....###
###.....#.....####################.....#.....###
###/....#..../####################/....#..../###
################################################
################################################
################################################
11,2|22,2|42,2|4,4|7,4|10,4|13,4|21,3|41,4|40,5|45,5|44,4|26,7|33,7|27,8|32,8|21,10|22,10|26,10|27,10|20,10|19,11|29,11|28,10|41,14|40,13|45,13|44,14|42,14|43,14|43,18|45,18|42,19|44,19|33,21|38,21|41,21|44,21|4,21|5,21|6,21|7,21|10,21|11,21|12,21|13,21|6,23|7,23|10,23|11,23|32,22|37,22|42,22|45,22|5,24|6,25|6,24|7,25|9,25|8,25|10,25|11,25|11,24|12,24|37,25|38,25|40,25|39,25|41,25|42,25|5,25|12,25|36,25|43,25|3,27|9,27|8,27|14,27|34,27|40,27|39,27|45,27|20,28|19,27|29,27|28,28|9,29|8,29|40,29|39,29|4,32|3,31|14,31|13,32|35,32|34,31|45,31|44,32|9,32|8,32|40,32|39,32|