Pièce : DS_A24
taille : 48x35
################################################
################################################
###############################=################
###############################|################
##############################.|.###############
##############################.|.###############
##############################.|.###############
##############################.|.###############
##############################...###############
##############################...###############
##############################...###############
##############################...###############
##############################...###############
##############################...###############
##############################...###############
##############################...###############
##############################...###############
#############################.....##############
###/........................................####
###............................#.............=##
###...........................####..........####
###...##########################################
###...##########################################
###...##########################################
###...##########################################
###...##########################################
###...##########################################
###...##########################################
###...##########################################
###...##########################################
###...##########################################
####.###########################################
####=###########################################
################################################
################################################
(3,31),(4,31)|(4,33),(5,31)|(5,33),(6,21)|(6,31),(29,17)|(29,18),(30,4)|(30,17),(30,20)|(30,21),(31,2)|(31,4),(31,19)|(31,20),(32,2)|(32,4),(32,19)|(32,20),(33,4)|(33,17),(34,17)|(34,18),(34,20)|(34,21),(44,18)|(44,19),(44,20)|(44,21),(46,19)|
(31,2),(32,2)|(30,4),(31,4)|(32,4),(33,4)|(29,17),(30,17)|(33,17),(34,17)|(29,18),(34,18)|(44,18),(31,19)|(32,19),(44,19)|(46,19),(30,20)|(31,20),(32,20)|(34,20),(44,20)|(46,20),(6,21)|(30,21),(34,21)|(44,21),(3,31)|(4,31),(5,31)|(6,31),(4,33)|

(3,19),(4,18)|
(31.5,3),(31.5,8)|

