Pièce : DS_A24
taille : 48x35
################################################
################################################
###############################=################
###############################|################
##############################.|.###############
##############################.|.###############
##############################.|.###############
##############################.|.###############
##############################...###############
##############################...###############
##############################...###############
##############################...###############
##############################...###############
##############################...###############
##############################...###############
##############################...###############
##############################...###############
#############################.....##############
###/........................................####
###............................#.............=##
###...........................####..........####
###...##########################################
###...##########################################
###...##########################################
###...##########################################
###...##########################################
###...##########################################
###...##########################################
###...##########################################
###...##########################################
###...##########################################
####.###########################################
####=###########################################
################################################
################################################
(4,31),(4,33)|(5,31),(5,33)|(6,21),(6,31)|(29,17),(29,18)|(30,4),(30,17)|(30,20),(30,21)|(31,2),(31,4)|(31,19),(31,20)|(32,2),(32,4)|(32,19),(32,20)|(33,4),(33,17)|(34,17),(34,18)|(34,20),(34,21)|(44,18),(44,19)|(44,20),(44,21)|(46,19),(46,20)|
(31,31),(32,2)|(30,30),(31,4)|(32,32),(33,4)|(29,29),(30,17)|(33,33),(34,17)|(29,29),(34,18)|(31,31),(32,19)|(44,44),(46,19)|(30,30),(31,20)|(32,32),(34,20)|(44,44),(46,20)|(6,6),(30,21)|(34,34),(44,21)|(3,3),(4,31)|(5,5),(6,31)|(4,4),(5,33)|

(3,19),(4,18)|
(31.5,3),(31.5,8)|

end file : DS_A24