Pièce : DS_A25
taille : 54x37
######################################################
######################################################
######################################################
######################################################
######################################################
######################################################
######################################################
#######....####.....#.....####....##....####...#######
######......##......#.....#.#............##.....######
####=...............#............................=####
######..........................................######
####=............................................=####
######..........................................######
####=......|.....................................=####
######.....|........#...........................######
######.....|........#........|....##............######
########...|......#####......|...####..........#######
########...|......#####......|...####..........#######
########...|..|...#####......|...####..........#######
########...|..|...#####......|...####...|......#######
########...|..|...#####......|...####...|......#######
########...|..|...#####...|..|...####...|......#######
########...|..|...#####...|..|...####...|......#######
########...|..|...#####...|..|...####...|..|...#######
########...|..|...#####...|..|...####...|..|...#######
########...|..|...#####...|..|...####...|..|...#######
########...|..|...#####...|..|...####...|..|...#######
########...|..|...#####...|..|...####...|..|...#######
########...|..|...#####...|..|...####...|..|...#######
########...|..|...#####...|..|...####...|..|...#######
########...|..|...#####...|..|...####...|..|...#######
########...|..|...#####...|..|...####...|..|...#######
###########H##H###########H##H##########H##H##########
##############=###########=##=##########=#############
######################################################
######################################################
######################################################
4,9|4,10|4,11|4,12|4,13|4,14|6,8|6,9|6,10|6,11|6,12|6,13|6,14|6,16|7,7|7,8|8,16|8,32|11,7|11,8|12,8|12,9|14,8|14,9|14,34|15,7|15,8|15,34|18,16|18,32|20,7|20,10|20,14|20,16|21,7|21,10|21,14|21,16|23,16|23,32|26,7|26,9|26,34|27,8|27,9|27,34|28,8|28,9|29,8|29,9|29,34|30,7|30,8|30,34|33,16|33,32|34,7|34,8|34,15|34,16|36,7|36,8|36,15|36,16|37,16|37,32|40,7|40,8|40,34|41,8|41,9|41,34|43,8|43,9|44,7|44,8|47,7|47,8|47,16|47,32|48,8|48,9|48,10|48,11|48,12|48,13|48,14|48,16|50,9|50,10|50,11|50,12|50,13|50,14|
(4,9),(4,10)|(4,11),(4,12)|(4,13),(4,14)|(6,8),(6,9)|(6,10),(6,11)|(6,12),(6,13)|(6,14),(6,16)|(7,7),(7,8)|(8,16),(8,32)|(11,7),(11,8)|(12,8),(12,9)|(14,8),(14,9)|(14,34),(15,7)|(15,8),(15,34)|(18,16),(18,32)|(20,7),(20,10)|(20,14),(20,16)|(21,7),(21,10)|(21,14),(21,16)|(23,16),(23,32)|(26,7),(26,9)|(26,34),(27,8)|(27,9),(27,34)|(28,8),(28,9)|(29,8),(29,9)|(29,34),(30,7)|(30,8),(30,34)|(33,16),(33,32)|(34,7),(34,8)|(34,15),(34,16)|(36,7),(36,8)|(36,15),(36,16)|(37,16),(37,32)|(40,7),(40,8)|(40,34),(41,8)|(41,9),(41,34)|(43,8),(43,9)|(44,7),(44,8)|(47,7),(47,8)|(47,16),(47,32)|(48,8),(48,9)|(48,10),(48,11)|(48,12),(48,13)|(48,14),(48,16)|(50,9),(50,10)|(50,11),(50,12)|(50,13),(50,14)|
(7,7),(11,7)|(15,7),(20,7)|(21,7),(26,7)|(30,7),(34,7)|(36,7),(40,7)|(44,7),(47,7)|(6,8),(7,8)|(11,8),(12,8)|(14,8),(15,8)|(27,8),(28,8)|(29,8),(30,8)|(34,8),(36,8)|(40,8),(41,8)|(43,8),(44,8)|(47,8),(48,8)|(4,9),(6,9)|(12,9),(14,9)|(26,9),(27,9)|(28,9),(29,9)|(41,9),(43,9)|(48,9),(50,9)|(4,10),(6,10)|(20,10),(21,10)|(48,10),(50,10)|(4,11),(6,11)|(48,11),(50,11)|(4,12),(6,12)|(48,12),(50,12)|(4,13),(6,13)|(48,13),(50,13)|(4,14),(6,14)|(20,14),(21,14)|(48,14),(50,14)|(34,15),(36,15)|(6,16),(8,16)|(18,16),(20,16)|(21,16),(23,16)|(33,16),(34,16)|(36,16),(37,16)|(47,16),(48,16)|(8,32),(18,32)|(23,32),(33,32)|(37,32),(47,32)|(14,34),(15,34)|(26,34),(27,34)|(29,34),(30,34)|(40,34),(41,34)|