Pièce : DS_A15
taille : 48x35
################################################
####################..#......##....#############
########..............#......##................#
################################################
################################################
########..............#......###################
########..............##########################
########.....................###################
########.....#############...###################
######.#.....#...#########...###################
######.#.....#...#########...###################
######.#...###############....=#################
######.#...#################.###################
######.#.....#.###########.#.###################
######.#.....#.#.#########.#...............#####
###############################.............=###
######.#.....#.#.##############............#####
######.#.....#.#.###############################
##########...#.#.#########...##............#####
######.#.....#.#.###############################
######.#.....#.#.###############################
################################################
######.#.....#.#.###############################
######.#....####################################
######.#.....#.#.###############################
######.#.....#.#.###############################
######.#.....#.#.###############################
################.###############################
########=#=#####################################
################################################
################################################
################################################
################################################
################################################
################################################
