Pièce : DS_A16
taille : 48x35
################################################
################################################
#####=##########################################
#####|################......####################
####.|....############......####################
#....|...................................#######
#....|.........................................#
#....|.........................................#
#####H#................./#/....................#
#....|........../#/.....###...../#/.....###....#
#....|..........###...../#/.....###.....#=#....#
#....|........../#/............./#/.....###....#
##...|................................../#/....#
###..|.........................................#
#####H###.....................................##
#####=#########......###.....................###
###########.####################################
###########.####################################
###########.####################################
###########.####################################
###########..................................###
###############...............................##
###############/...............................#
################/..............................#
#################/.............................#
##################/............................#
###################/...........................#
####################/..........................#
#####################/.........................#
######################/........................#
#######################/.....................###
########################/####............#######
################################################
##################################=#=#=#########
################################################
(1,5),(1,8)|(1,9),(1,12)|(2,12),(2,13)|(3,13),(3,14)|(4,4),(4,5)|(5,2),(5,16)|(6,2),(6,16)|(7,8),(7,9)|(9,14),(9,15)|(10,4),(10,5)|(11,16),(11,21)|(12,16),(12,20)|(15,15),(15,16)|(15,21),(21,15)|(21,16),(22,3)|(22,5),(24,15)|(24,16),(28,3)|(28,5),(29,31)|(29,32),(34,33)|(34,34),(35,33)|(35,34),(36,33)|(36,34),(37,33)|(37,34),(38,33)|(38,34),(39,33)|(39,34),(40,9)|(41,5),(41,6)|(41,10),(41,11)|(41,31),(41,32)|(42,10),(42,11)|(43,9),(45,15)|(45,16),(45,20)|(45,21),(45,30)|(45,31),(46,14)|(46,15),(46,21)|(46,22),(47,6)|(47,14),(47,22)|
(5,2),(6,2)|(22,3),(28,3)|(4,4),(10,4)|(1,5),(4,5)|(10,5),(22,5)|(28,5),(41,5)|(41,6),(47,6)|(1,8),(7,8)|(1,9),(7,9)|(40,9),(43,9)|(41,10),(42,10)|(41,11),(42,11)|(1,12),(2,12)|(2,13),(3,13)|(3,14),(9,14)|(46,14),(47,14)|(9,15),(15,15)|(21,15),(24,15)|(45,15),(46,15)|(5,16),(6,16)|(11,16),(12,16)|(15,16),(21,16)|(24,16),(45,16)|(12,20),(45,20)|(11,21),(15,21)|(45,21),(46,21)|(46,22),(47,22)|(45,30),(47,30)|(29,31),(41,31)|(45,31),(29,32)|(41,32),(34,33)|(35,33),(36,33)|(37,33),(38,33)|(39,33),(34,34)|(35,34),(36,34)|(37,34),(38,34)|