Piece : DS_B03
54x78
-98x37
######################################################
######################################################
######################################################
######################################################
######################################################
######################################################
######################################################
######################################################
######################################################
##########/.##.......##.......##.........##/##########
#########/..###########.......##.........##./#########
########/...###########.......#############../########
#######.......................#############....#######
#####=..........................................=#####
#######..|..................................H#########
#####=...|..................................|...=#####
#########H..................................|..#######
#####=...|..................................|...=#####
#######..|....../#/.........................|..#######
###########.....###............|...........###########
########.##...../#/............|...........#=#########
########.##............../#/...|.../#/.....###########
########.##||............###...|...###...||###########
########.##............../#/...|.../#/.....###########
########.......................|...........###########
###########||..................|..........|###########
###########/...................|........../###########
############/..................|........./############
################...######...###H###...################
################...######...###=###...################
################...######...#######...################
################...######...#######...################
###############/.|./####/.|./#####/.../###############
###############..|..####..|..#####.....###############
###############..|..####..|..#####.....###############
###############..|..####..|..#####.....###############
###############..|..####..|..#####.....###############
###############..|..####..|..#####.....###############
###############..|..####..|..#####.....###############
###############..|..####..|..#####.....###############
###############..|..####..|..#####.....###############
###############..|..####..|..#####.....###############
###############..|..####..|..#####.....###############
###############..|..####..|..#####.....###############
###############..|..####..|..#####.....###############
###############..|..####..|..#####.....###############
###############..|..####..|..#####.....###############
###############..|..####..|..#####.....###############
###############..|..####..|..#####.....###############
###############..|..####..|..#####.....###############
###############..|..####..|..#####.....###############
###############..|..####..|..#####.....###############
###############..|..####..|..#####.....###############
###############..|..####..|..#####.....###############
###############..|..####..|..#####.....###############
###############..|..####..|..#####.....###############
###############..|..####..|..#####.....###############
###############..|..####..|..#####.....###############
###############..|..####..|..#####.....###############
###############..|..####..|..#####.....###############
###############..|..####..|..#####.....###############
###############/.|./####..|..#####.....###############
#################H######..|..#####.....###############
########################..|..#####.....###############
########################..|..#####.....###############
########################..|..#####.....###############
########################..|..#####.....###############
########################/.|./#####.....###############
##########################H#######.....###############
##########################=#######.....###############
##################################/.../###############
######################################################
####################################=#################
######################################################
######################################################
######################################################
######################################################
######################################################
(5,13),(5,14)|(5,15),(5,16)|(5,17),(5,18)|(7,12),(7,13)|(7,14),(7,15)|(7,18),(7,19)|(8,20),(8,25)|(9,16),(9,17)|(9,20),(9,24)|(11,9),(11,19)|(11,24),(11,25)|(12,9),(12,12)|(14,9),(14,10)|(15,33),(15,61)|(16,19),(16,20)|(16,28),(16,32)|(17,62),(17,63)|(18,62),(18,63)|(19,19),(19,20)|(19,28),(19,32)|(20,32.5),(20,33)|(21,9),(21,10)|(23,9),(23,12)|(24,33),(24,67)|(25,22),(25,23)|(25,28),(25,32)|(26,68),(26,70)|(27,68),(27,70)|(28,22),(28,23)|(28,28),(28,32)|(29,32.5),(29,33)|(30,9),(30,13)|(31,28),(31,30)|(32,9),(32,11)|(32,28),(32,30)|(34,33),(34,70)|(35,22),(35,23)|(35,28),(35,32)|(36,72),(36,73)|(37,72),(37,73)|(38,22),(38,23)|(38,28),(38,32)|(39,32.5),(39,33)|(41,9),(41,11)|(43,10),(43,13)|(43,19),(43,26)|(44,20),(44,21)|(45,14),(45,15)|(45,20),(45,21)|(47,12),(47,13)|(47,16),(47,17)|(47,18),(47,19)|(49,13),(49,14)|(49,15),(49,16)|(49,17),(49,18)|
(11,9),(12,9)|(14,9),(21,9)|(23,9),(30,9)|(32,9),(41,9)|(14,10),(21,10)|(32,11),(41,11)|(7,12),(8,12)|(12,12),(23,12)|(46,12),(47,12)|(5,13),(7,13)|(30,13),(43,13)|(47,13),(49,13)|(5,14),(7,14)|(45,14),(49,14)|(5,15),(7,15)|(45,15),(49,15)|(5,16),(9,16)|(47,16),(49,16)|(5,17),(9,17)|(47,17),(49,17)|(5,18),(7,18)|(17,18),(18,18)|(47,18),(49,18)|(7,19),(11,19)|(43,19),(47,19)|(8,20),(9,20)|(44,20),(45,20)|(17,21),(18,21)|(26,21),(27,21)|(36,21),(37,21)|(44,21),(45,21)|(9,24),(11,24)|(26,24),(27,24)|(36,24),(37,24)|(8,25),(11,25)|(11,26),(43,26)|(12.5,28),(13,28)|(16,28),(19,28)|(25,28),(28,28)|(31,28),(32,28)|(35,28),(38,28)|(31,30),(32,30)|(15,33),(20,33)|(24,33),(29,33)|(34,33),(39,33)|(15,61),(20,61)|(15.5,62),(16,62)|(17,62),(18,62)|(17,63),(18,63)|(24,67),(29,67)|(24.5,68),(25,68)|(26,68),(27,68)|(26,70),(27,70)|(34,70),(39,70)|(34.5,71),(35,71)|(36,72),(37,72)|(36,73),(37,73)|
(11,26),(13,28)|(15,61),(16,62)|(16,20),(17,21)|(16,20),(28,32)|(16,20),(29,33)|(18,18),(19,19)|(19,32),(20,33)|(24,67),(25,68)|(25,23),(26,24)|(27,21),(28,22)|(27,21),(38,32)|(27,21),(39,33)|(34,70),(35,71)|(35,23),(36,24)|(37,21),(38,22)|
(8,12),(11,9)|(15,33),(16,32)|(16,19),(17,18)|(18,21),(19,20)|(19,62),(20,61)|(24,33),(25,32)|(24,33),(35,22)|(24,33),(36,21)|(25,22),(26,21)|(27,24),(28,23)|(28,68),(29,67)|(34,33),(35,32)|(37,24),(38,23)|(38,71),(39,70)|(41,28),(43,26)|
(9.5,14),(9.5,16)|(9.5,17),(9.5,19)|(11.5,22),(11.5,23)|(11.5,25),(11.5,26)|(12.5,22),(12.5,23)|(12.5,25),(12.5,26)|(17.5,32),(17.5,62)|(26.5,32),(26.5,68)|(31.5,19),(31.5,28)|(41.5,22),(41.5,23)|(42.5,22),(42.5,23)|(42.5,25),(42.5,26)|(44.5,15),(44.5,19)|
None|
end file : DS_B03