Pièce : DS_B02
taille : 100x35
####################################################################################################
####################################################################################################
####################################################################################################
####################################################################################################
####################################################################################################
#################################=##################################################################
######/.................#....../#|#/.......#..................#......###.....#......###.....#./#####
######..................#........|.........#..................#......###.....#......###.....#..#####
######..................#........|.........#..................#......###............###.....#..#####
####=...................#........|.........#..................#......###............###.....#...=###
######..................#............................................####............|.........#####
####=................................................................###.............|..........=###
######.....................................#........................./#/............####.......#####
####=...................#..................#..................#.....................###.........=###
######..................#....../###/.......##/............./###..............##...../#/.....#..#####
########................##/../########/...#####...........#######..........#####..........##########
#################################################################..........#####..........##########
#####=........................................................=##..........#####...|......##########
#################################################################......|...#####...|......##########
#################################################################......|...#####...|..|...##########
#################################################################......|...#####...|..|...##########
#################################################################......|...#####...|..|...##########
#################################################################......|...#####...|..|...##########
#################################################################......|...#####...|..|...##########
#################################################################...|..|...#####...|..|...##########
#################################################################...|..|...#####...|..|...##########
#################################################################...|..|...#####...|..|...##########
#################################################################...|..|...#####...|..|...##########
#################################################################...|..|...#####...|..|...##########
#################################################################...|..|...#####...|..|...##########
#################################################################...|..|...#####...|..|...##########
#################################################################...|..|...#####...|..|...##########
####################################################################|##|###########|##|#############
####################################################################=##=###########=##=#############
####################################################################################################
(4,9),(4,10)|(4,11),(4,12)|(4,13),(4,14)|(5,17),(5,18)|(6,9),(6,10)|(6,11),(6,12)|(6,13),(6,14)|(8,15),(8,16)|(24,6),(24,11)|(24,13),(24,16)|(25,6),(25,11)|(25,13),(25,15)|(33,5),(33,7)|(34,5),(34,7)|(42,15),(42,16)|(43,6),(43,10)|(43,12),(43,15)|(44,6),(44,10)|(44,12),(44,14)|(47,15),(47,16)|(58,15),(58,16)|(62,6),(62,10)|(62,13),(62,14)|(63,6),(63,10)|(63,13),(63,15)|(63,17),(63,18)|(65,15),(65,32)|(68,32),(68,34)|(69,6),(69,12)|(69,32),(69,34)|(71,32),(71,34)|(72,6),(72,10)|(72,11),(72,12)|(72,32),(72,34)|(73,10),(73,11)|(75,15),(75,32)|(77,6),(77,8)|(77,14),(77,15)|(78,6),(78,8)|(79,14),(79,15)|(80,15),(80,32)|(83,32),(83,34)|(84,6),(84,10)|(84,12),(84,14)|(84,32),(84,34)|(86,32),(86,34)|(87,6),(87,10)|(87,13),(87,14)|(87,32),(87,34)|(88,12),(88,13)|(90,15),(90,32)|(92,6),(92,10)|(92,14),(92,15)|(93,6),(93,10)|(93,14),(93,15)|(95,9),(95,10)|(95,11),(95,12)|(95,13),(95,14)|(97,9),(97,10)|(97,11),(97,12)|(97,13),(97,14)|
(33,5),(34,5)|(24,6),(25,6)|(43,6),(44,6)|(62,6),(63,6)|(69,6),(72,6)|(77,6),(78,6)|(84,6),(87,6)|(92,6),(93,6)|(32,7),(33,7)|(34,7),(35,7)|(77,8),(78,8)|(4,9),(6,9)|(95,9),(97,9)|(4,10),(6,10)|(43,10),(44,10)|(62,10),(63,10)|(72,10),(73,10)|(84,10),(87,10)|(92,10),(93,10)|(95,10),(97,10)|(4,11),(6,11)|(24,11),(25,11)|(72,11),(73,11)|(95,11),(97,11)|(4,12),(6,12)|(43,12),(44,12)|(84,12),(88,12)|(95,12),(97,12)|(4,13),(6,13)|(24,13),(25,13)|(62,13),(63,13)|(70,13),(71,13)|(87,13),(88,13)|(95,13),(97,13)|(4,14),(6,14)|(32,14),(35,14)|(44,14),(45,14)|(60,14),(62,14)|(77,14),(79,14)|(92,14),(93,14)|(95,14),(97,14)|(6,15),(8,15)|(25,15),(26,15)|(30,15),(38,15)|(42,15),(43,15)|(47,15),(58,15)|(63,15),(65,15)|(75,15),(77,15)|(79,15),(80,15)|(85,15),(86,15)|(90,15),(92,15)|(93,15),(95,15)|(8,16),(24,16)|(42,16),(47,16)|(5,17),(63,17)|(5,18),(63,18)|(65,32),(68,32)|(69,32),(71,32)|(72,32),(75,32)|(80,32),(83,32)|(84,32),(86,32)|(87,32),(90,32)|(68,34),(69,34)|(71,34),(72,34)|(83,34),(84,34)|(86,34),(87,34)|
(26,15),(27,16)|(31,6),(32,7)|(35,14),(36,15)|(38,15),(39,16)|(45,14),(46,15)|(69,12),(70,13)|(84,14),(85,15)|(94,6),(95,7)|
(6,7),(7,6)|(29,16),(30,15)|(31,15),(32,14)|(35,7),(36,6)|(59,15),(60,14)|(71,13),(72,12)|(86,15),(87,14)|
(33.5,6),(33.5,10)|(68.5,24),(68.5,33)|(71.5,18),(71.5,33)|(83.5,17),(83.5,33)|(85.5,10),(85.5,12)|(86.5,19),(86.5,33)|

end file : DS_B02