Pièce : DS_B08
taille : 48x78
################################################
################################################
################################################
################################################
################################################
################################################
################################################
################################################
################################################
################################################
################################################
################################################
################################################
################################################
################################################
################################################
################################################
################################################
################################################
################################################
################################################
################################################
################################################
################################################
################################################
################################################
################################################
################################################
################################################
################################################
################################################
###############/............................####
###############..............................=##
###############.............................####
###############...##############################
###############...##############################
###############...##############################
###############...##############################
###############...##############################
###############...##############################
###############...##############################
###############...##############################
###############...##############################
###############...##############################
###############...##############################
###############...##############################
###############.|.##############################
###############.|.##############################
###############.|.##############################
###############.|.##############################
###############.|.##############################
###############.|.##############################
###############.|.##############################
###############.|.##############################
###############.|.##############################
###############.|.##############################
###############.|.##############################
###############.|.##############################
###############.|.##############################
###############.|.##############################
###############.|.##############################
###############.|.##############################
###############.|.##############################
###############.|.##############################
###############.|.##############################
###############.|.##############################
###############.|.##############################
###############.|.##############################
###############.|.##############################
###############.|.##############################
###############.|.##############################
################|###############################
################=###############################
################################################
################################################
################################################
################################################
################################################
16,31|15,32|44,32|44,33|18,34|44,34|15,71|18,71|