Pièce : DS_B07
taille : 110x38
##############################################################################################################
###########=###################=################=##################=################=#########################
###########|###################|################|##################|################|#########################
######/....|....####.....####..|..####.....####.|...####.....####..|..####..........|.........|......./#######
######.....|....####.....####..|..####.....####.|...####.....####..|..####..........|.........|........#######
######.....|....####.....####..|..####.....####.|...####.....####..|..####..........|.........|........#######
####=......|....####.....####..|..####.....####.|...####......##...|..#.#...........|.........|.........=#####
#########..|......#......####..|....#......###..|...####...........|................|.........|..#############
#########..|.............####..|....#.......##..|...#.#............|................|.........|..#############
#########..|..............##...|................|..................|................|.........|.##############
###........|..............#....|................|..................|................|.........|###############
###.###########################H#..............#H###################................##########################
###.#####......................|................|..................|................|.........|..#############
###.#####.......................................|..................|................|............#############
###.#####.......................................|..................|............................##############
###.#####.......................................|................................................#############
###.#####............||#|||||#||#...............|................................................#############
###.#####.......................................|........................................###.....#############
###.#####.......................................|........................................###.....#############
###.#####.......................................|........................................###.....#############
###.#####.............................##########H.........................................|......#############
###.#####.......................................|.........................................|......#############
###.#####.......................................|....###..................................|......#############
###.##/|......................###...............|....###.................###..............|.....##############
###.##.|......................#.#......###......|....###.................###..............|....###############
###....|......................#+#......###......|.....|.......###........###........#####.|.##################
######.|...###.................|.......###............|.......###.........|.........#####.|.##################
######.|...###.......###.......|........|.............|.......###.........|.........#####.|.##################
######.|...###.......###.......|........|.............|........|..........|.........#####.|.##################
######.|....|........###................|......................|..........|.........#####.|.##################
####=..|....|.........|........................................|....................#####.|.##################
#########...|.........|........................................|...................#######H###################
#########.............|..........................................................#############################
#########/.....................................................................###############################
##############################################################################################################
######################=#################=######################=##############################################
##############################################################################################################
##############################################################################################################
3,10|3,26|4,6|4,7|4,11|4,25|4,30|4,31|6,6|6,25|6,26|6,30|9,7|9,10|9,12|9,23|9,31|11,1|11,26|11,29|12,1|14,26|14,29|16,3|16,7|18,7|18,8|19,7|19,8|20,3|20,7|21,27|21,30|22,35|22,36|23,35|23,36|24,27|24,30|25,3|25,9|26,9|26,11|27,10|27,11|28,9|28,10|29,3|29,9|30,23|30,26|31,1|31,24|32,1|32,24|33,11|33,12|33,16|33,17|33,23|33,26|34,3|34,7|36,7|36,9|37,7|37,9|38,3|38,7|38,20|38,21|39,24|39,27|40,35|40,36|41,35|41,36|42,24|42,27|43,3|43,8|44,8|44,9|46,7|46,9|47,3|47,7|47,11|47,12|48,1|49,1|52,3|52,9|53,8|53,9|53,22|53,25|54,8|54,9|55,8|55,9|56,3|56,8|56,22|56,25|61,3|61,6|62,6|62,7|62,25|62,28|63,35|63,36|64,6|64,7|64,35|64,36|65,3|65,6|65,25|65,28|67,1|68,1|70,3|70,7|71,6|71,7|72,6|72,7|73,6|73,7|73,23|73,26|74,3|74,6|76,23|76,26|79,33|79,34|81,32|81,33|83,31|83,32|84,1|84,25|84,31|85,1|89,17|89,20|89,25|89,31|92,17|92,20|92,25|92,31|95,24|95,25|96,9|96,10|96,14|96,15|96,23|96,24|97,7|97,9|97,12|97,14|97,15|97,23|103,6|105,6|105,7|
(3,10),(3,26)|(4,6),(4,7)|(4,11),(4,25)|(4,30),(4,31)|(6,6),(6,25)|(6,26),(6,30)|(9,7),(9,10)|(9,12),(9,23)|(9,31),(11,1)|(11,26),(11,29)|(12,1),(14,26)|(14,29),(16,3)|(16,7),(18,7)|(18,8),(19,7)|(19,8),(20,3)|(20,7),(21,27)|(21,30),(22,35)|(22,36),(23,35)|(23,36),(24,27)|(24,30),(25,3)|(25,9),(26,9)|(26,11),(27,10)|(27,11),(28,9)|(28,10),(29,3)|(29,9),(30,23)|(30,26),(31,1)|(31,24),(32,1)|(32,24),(33,11)|(33,12),(33,16)|(33,17),(33,23)|(33,26),(34,3)|(34,7),(36,7)|(36,9),(37,7)|(37,9),(38,3)|(38,7),(38,20)|(38,21),(39,24)|(39,27),(40,35)|(40,36),(41,35)|(41,36),(42,24)|(42,27),(43,3)|(43,8),(44,8)|(44,9),(46,7)|(46,9),(47,3)|(47,7),(47,11)|(47,12),(48,1)|(49,1),(52,3)|(52,9),(53,8)|(53,9),(53,22)|(53,25),(54,8)|(54,9),(55,8)|(55,9),(56,3)|(56,8),(56,22)|(56,25),(61,3)|(61,6),(62,6)|(62,7),(62,25)|(62,28),(63,35)|(63,36),(64,6)|(64,7),(64,35)|(64,36),(65,3)|(65,6),(65,25)|(65,28),(67,1)|(68,1),(70,3)|(70,7),(71,6)|(71,7),(72,6)|(72,7),(73,6)|(73,7),(73,23)|(73,26),(74,3)|(74,6),(76,23)|(76,26),(79,33)|(79,34),(81,32)|(81,33),(83,31)|(83,32),(84,1)|(84,25),(84,31)|(85,1),(89,17)|(89,20),(89,25)|(89,31),(92,17)|(92,20),(92,25)|(92,31),(95,24)|(95,25),(96,9)|(96,10),(96,14)|(96,15),(96,23)|(96,24),(97,7)|(97,9),(97,12)|(97,14),(97,15)|(97,23),(103,6)|(105,6),(105,7)|
(11,1),(12,1)|(31,1),(32,1)|(48,1),(49,1)|(67,1),(68,1)|(84,1),(85,1)|(16,3),(20,3)|(25,3),(29,3)|(34,3),(38,3)|(43,3),(47,3)|(52,3),(56,3)|(61,3),(65,3)|(70,3),(74,3)|(4,6),(6,6)|(61,6),(62,6)|(64,6),(65,6)|(71,6),(72,6)|(73,6),(74,6)|(103,6),(105,6)|(4,7),(9,7)|(16,7),(18,7)|(19,7),(20,7)|(34,7),(36,7)|(37,7),(38,7)|(46,7),(47,7)|(62,7),(64,7)|(70,7),(71,7)|(72,7),(73,7)|(97,7),(105,7)|(18,8),(19,8)|(43,8),(44,8)|(53,8),(54,8)|(55,8),(56,8)|(25,9),(26,9)|(28,9),(29,9)|(36,9),(37,9)|(44,9),(46,9)|(52,9),(53,9)|(54,9),(55,9)|(96,9),(97,9)|(3,10),(9,10)|(27,10),(28,10)|(96,10),(4,11)|(26,11),(27,11)|(33,11),(47,11)|(9,12),(33,12)|(47,12),(97,12)|(96,14),(97,14)|(96,15),(97,15)|(33,16),(33,17)|(89,17),(92,17)|(38,20),(89,20)|(92,20),(38,21)|(53,22),(56,22)|(9,23),(30,23)|(33,23),(73,23)|(76,23),(96,23)|(97,23),(31,24)|(32,24),(39,24)|(42,24),(95,24)|(96,24),(4,25)|(6,25),(53,25)|(56,25),(62,25)|(65,25),(84,25)|(89,25),(92,25)|(95,25),(3,26)|(6,26),(11,26)|(14,26),(30,26)|(33,26),(73,26)|(76,26),(21,27)|(24,27),(39,27)|(42,27),(62,28)|(65,28),(11,29)|(14,29),(4,30)|(6,30),(21,30)|(24,30),(4,31)|(9,31),(83,31)|(84,31),(89,31)|(92,31),(81,32)|(83,32),(79,33)|(81,33),(79,34)|(22,35),(23,35)|(40,35),(41,35)|(63,35),(64,35)|(22,36),(23,36)|(40,36),(41,36)|(63,36),(64,36)|