Pièce : DS_C01
taille : 54x121
######################################################
######################################################
######################################################
######################################################
######################################################
#########/..###.........######............../#########
########/...###.........######.............../########
#######/....###.........######................/#######
######/.....###.........######................./######
######......###.................................######
######......###.................................######
######......###.................................######
######......###.................................######
######......###.................................######
######.......|..................................######
####=........|...................................=####
######.......|.........................|........######
####=........|.........................|.........=####
##########|..|..|##|#|.................|........######
######|..|...|...|..|..................|.........=####
########.|...|...|..|..................||.......######
###########..|..######..........###....||....#########
###########..|..######..........###....||....#########
###########..|..######..........###....||....#########
###########..|..######..........###....||....#########
###########..|..######..........###...#||....#########
###########..|..######..........###..##||.#/.#########
###########..|..######..........###./###|/##.#########
###########/.|./######..........###/####|###/#########
############.|.#######..........########=#############
############.|.#######..........######################
############.|.#######..........######################
############...#######..........######################
############...#######..........######################
############...#######..........######################
############...#######..........######################
############...#######..........######################
############...#######..........######################
############...#######..........######################
############...#######..........######################
############...#######..........######################
############...#######..........######################
############...#######..........######################
############...#######..........########=#############
############...#######..........########|#############
###########/.|./######..........######/.|./###########
###########..|..######..........######..|..###########
###########..|..######..........######..|..###########
###########..|..######..........######..|..###########
###########..|..######..........######..|..###########
###########..|..######..........######..|..###########
###########..|..######..........######..|..###########
###########..|..######..........######..|..###########
###########..|..######..........######..|..###########
###########..|..######..........######..|..###########
###########..|..######..........######..|..###########
###########..|..######..........######..|..###########
###########..|..######..........######..|..###########
###########..|..######..........######..|..###########
###########..|..######..........######..|..###########
###########..|..######..........######..|..###########
###########/.|./######..........######/.|./###########
#############H########..........########H#############
#############=########..........########=#############
######################..........######################
######################..........######################
######################..........######################
######################..........######################
######################..........######################
######################..........######################
######################..........######################
######################..........######################
######################..........######################
######################..........######################
######################..........######################
######################..........######################
######################..........######################
######################..........######################
######################..........######################
######.....####.....##..........##.....####.....######
######.....####.....##..........##.....####.....######
######.....####........................####.....######
######.....####........................####.....######
######.....####........................####.....######
#####/......#...........................##....../#####
#####............................................#####
#####............................................#####
#####............................................#####
#####..................|.........................#####
#####..................|............/#/..........#####
#####........../#/.....|............###..........#####
#####..........###.....|............/#/..........#####
#####........../#/.....|.....................#########
#####..................|.....................#########
#####..................|.....................#########
#######................|.....................#########
#####=.................|.....................#########
############...........|.........................#####
############...........|.........................#####
############...........|.........................#####
############...........|.........|...............#####
############...........|.........|........|......#####
#####..................|.........|........|......#####
#####..................|.........|........|......#####
#####..................|.........|.......#?#.....#####
######.................|.........|.......#=#....######
######/................|.........|.......###...#######
########/..............|......./###......###.#########
###########........####|.......#####/....#############
############/....#########../##########..#############
###############.#######################.##############
###############=#######################=##############
######################################################
######################################################
######################################################
######################################################
######################################################
######################################################
######################################################
######################################################
######################################################
(4,15),(4,16)|(4,17),(4,18)|(5,95),(5,96)|(5,97),(5,102)|(5,105),(6,15)|(6,16),(6,17)|(6,79),(6,105)|(7,95),(7,96)|(8,20),(8,21)|(11,21),(11,79)|(11,84),(11,108)|(11,109),(12,5)|(12,14),(12,84)|(12,85),(12,97)|(12,102),(13,64)|(13,84),(13,85)|(14,64),(15,5)|(15,14),(15,79)|(15,84),(15,110)|(15,112),(16,21)|(16,110),(16,112)|(17,109),(17,110)|(19,108),(19,109)|(20,79),(20,81)|(22,21),(22,81)|(24,5),(24,9)|(26,109),(26,110)|(30,5),(30,9)|(31,109),(32,21)|(32,81),(34,79)|(34,81),(35,21)|(35,107),(35,108)|(37,26),(38,25)|(38,26),(39,79)|(39,84),(39,109)|(39,112),(40,30)|(40,43),(40,64)|(40,84),(40,85)|(40,110),(40,112)|(41,30),(41,43)|(41,64),(41,104)|(41,110),(42,26)|(42,84),(42,85)|(42,106),(43,79)|(43,84),(43,106)|(44,104),(44,108)|(45,21),(45,92)|(45,97),(45,107)|(45,108),(47,106)|(47,107),(48,15)|(48,16),(48,17)|(48,18),(48,19)|(48,20),(48,21)|(48,79),(48,105)|(48,106),(49,92)|(49,97),(49,105)|(50,15),(50,16)|(50,17),(50,18)|(50,19),(50,20)|
(12,5),(15,5)|(24,5),(30,5)|(24,9),(30,9)|(12,14),(15,14)|(4,15),(6,15)|(48,15),(50,15)|(4,16),(6,16)|(48,16),(50,16)|(4,17),(6,17)|(48,17),(50,17)|(4,18),(48,18)|(50,18),(48,19)|(50,19),(8,20)|(48,20),(50,20)|(8,21),(11,21)|(16,21),(22,21)|(32,21),(35,21)|(45,21),(48,21)|(38,25),(37,26)|(38,26),(42,26)|(40,30),(41,30)|(40,43),(41,43)|(13,64),(14,64)|(40,64),(41,64)|(6,79),(11,79)|(15,79),(20,79)|(34,79),(39,79)|(43,79),(48,79)|(20,81),(22,81)|(32,81),(34,81)|(11,84),(12,84)|(13,84),(15,84)|(39,84),(40,84)|(42,84),(43,84)|(12,85),(13,85)|(40,85),(42,85)|(45,92),(49,92)|(5,95),(7,95)|(5,96),(7,96)|(5,97),(12,97)|(45,97),(49,97)|(5,102),(12,102)|(41,104),(44,104)|(5,105),(6,105)|(48,105),(49,105)|(42,106),(43,106)|(47,106),(48,106)|(35,107),(45,107)|(47,107),(11,108)|(19,108),(35,108)|(44,108),(45,108)|(11,109),(17,109)|(19,109),(26,109)|(31,109),(39,109)|(15,110),(16,110)|(17,110),(26,110)|(40,110),(41,110)|(15,112),(16,112)|(39,112),(40,112)|
(6,106),(7,107)|(8,107),(9,108)|(11,28),(12,29)|(11,61),(12,62)|(12,109),(13,110)|(15,45),(16,46)|(15,92),(16,93)|(17,90),(18,91)|(36,91),(37,92)|(36,108),(37,109)|(38,61),(39,62)|(38,89),(39,90)|(42,45),(43,46)|(43,26),(44,27)|(44,5),(48,9)|(48,84),(49,85)|
(5,85),(6,84)|(6,9),(10,5)|(11,46),(12,45)|(15,29),(16,28)|(15,62),(16,61)|(15,91),(16,90)|(17,93),(18,92)|(28,110),(29,109)|(31,108),(32,107)|(35,29),(37,27)|(36,90),(37,89)|(38,46),(39,45)|(38,92),(39,91)|(41,28),(42,27)|(42,62),(43,61)|(44,29),(45,28)|
