Pièce : SI_A15
taille : 48x35
################################################
################################################
################################################
################################################
################################################
############################################=###
############################################.###
############################################.###
############################################.###
#####=######################################.###
#####.######################################.###
#####.######################################.###
#####.######################################.###
#####.#########################...........##.###
#####.######################.................###
#####.######################.##...........######
#####.######################.###################
#####.######################.###################
#####.######################.###################
#####.######################.###################
#####.######################.###################
#####.######################.###################
#####.######################.................###
#####.######################################.###
#####.######################################.###
#####.######################################.###
#####.###########..................#########.###
#####........................................###
#################..................#############
################################################
################################################
################################################
################################################
################################################
################################################
(5,9),(5,28)|(6,9),(6,27)|(17,26),(17,27)|(17,28),(17,29)|(28,14),(28,23)|(29,15),(29,22)|(31,13),(31,14)|(31,15),(31,16)|(35,26),(35,27)|(35,28),(35,29)|(42,13),(42,14)|(42,15),(42,16)|(44,5),(44,14)|(44,23),(44,27)|(45,5),(45,15)|(45,22),(45,28)|
(44,5),(45,5)|(5,9),(6,9)|(31,13),(42,13)|(28,14),(31,14)|(42,14),(44,14)|(29,15),(31,15)|(42,15),(45,15)|(31,16),(42,16)|(29,22),(45,22)|(28,23),(44,23)|(17,26),(35,26)|(6,27),(17,27)|(35,27),(44,27)|(5,28),(17,28)|(35,28),(45,28)|(17,29),(35,29)|


