Pièce : SI_B09
taille : 110x37
..............................................................................................................
..............................................................................................................
..............................................................................................................
..............................................................................................................
..............................................................................................................
..............................................................................................................
..............................................................................................................
..............................................................................................................
..............................................................................................................
..................................................................................................|...........
..................................................................................................|...........
..................................................................................................|...........
....................../#/............................................./#/.........................|.##........
......................###.............................................###.........................|.##........
....................../#/.........../#/.............................../#/.........................|.##........
.......................|............###................................|.......##HH#########/....-+-##........
.......................|............/#/................................|.......##..#####=#=##/....|.##........
.......................|.............|.................................|.......##..###########/...|.##........
.......................|.............|.................................|........|..|...########...|.##........
.......................|.............|.................................|........+--+...########...|.##........
.......................|.............|.................................|........|..|...########...|.##........
.......................|.............|.................................|........|..|...########..-+-##........
.......................|.............|.................................|........+--+...########...|.##........
......................###............|.......#################.###.....|........|..|..#########...|.##........
..................############.......|.######################################...|..|.##########...|...........
..............#######################H##########################################H##H###########...|...........
..............#######################=##########################################=##=#########=....|...........
..............#################################################################################...|...........
........#############################################################################################.........
........#############################################################################################.........
........#############################################################################################.........
..............#################################################################################...|...........
..............#################################################################################...|...........
..............#################################################################################...|...........
..............#################################################################################...|...........
..............#################################################################################...............
..............#################################################################################...............
(8,28),(8,31)|(14,25),(14,28)|(14,31),(14,37)|(18,24),(18,25)|(22,23),(22,24)|(25,23),(25,24)|(30,24),(30,25)|(37,25),(37,27)|(38,25),(38,27)|(39,24),(39,25)|(45,23),(45,24)|(62,23),(62,24)|(63,23),(63,24)|(66,23),(66,24)|(77,24),(77,25)|(79,15),(79,18)|(80,25),(80,27)|(81,15),(81,18)|(81,25),(81,27)|(83,15),(83,18)|(83,25),(83,27)|(84,25),(84,27)|(85,24),(85,25)|(86,23),(86,24)|(87,18),(87,23)|(88,16),(88,17)|(89,16),(89,17)|(90,16),(90,17)|(91,16),(91,17)|(93,26),(93,27)|(95,26),(95,27)|(95,28),(95,31)|(100,12),(100,24)|(101,28),(101,31)|(102,12),(102,24)|
(100,100),(102,12)|(79,79),(81,15)|(88,88),(89,16)|(90,90),(91,16)|(88,88),(89,17)|(90,90),(91,17)|(79,79),(81,18)|(83,83),(87,18)|(22,22),(25,23)|(45,45),(62,23)|(63,63),(66,23)|(86,86),(87,23)|(18,18),(22,24)|(25,25),(30,24)|(39,39),(45,24)|(62,62),(63,24)|(66,66),(77,24)|(85,85),(86,24)|(100,100),(102,24)|(14,14),(18,25)|(30,30),(37,25)|(38,38),(39,25)|(77,77),(80,25)|(81,81),(83,25)|(84,84),(85,25)|(93,93),(95,26)|(37,37),(38,27)|(80,80),(81,27)|(83,83),(84,27)|(93,93),(95,27)|(8,8),(14,28)|(95,95),(101,28)|(8,8),(14,31)|(95,95),(101,31)|(14,14),(95,37)|
(22,14),(23,15)|(24,12),(25,13)|(36,16),(37,17)|(38,14),(39,15)|(70,14),(71,15)|(72,12),(73,13)|(92,15),(95,18)|
(22,13),(23,12)|(24,15),(25,14)|(36,15),(37,14)|(38,17),(39,16)|(70,13),(71,12)|(72,15),(73,14)|
(23.5,15),(23.5,23)|(37.5,17),(37.5,25)|(71.5,15),(71.5,24)|(80.5,18),(80.5,25)|(83.5,18),(83.5,25)|(98.5,9),(98.5,28)|(98.5,31),(98.5,35)|
(97,15.5),(97,21.5)|(100,15.5),(100,21.5)|
end file : SI_B09