Pièce : SI_B09
taille : 110x37
..............................................................................................................
..............................................................................................................
..............................................................................................................
..............................................................................................................
..............................................................................................................
..............................................................................................................
..............................................................................................................
..............................................................................................................
..............................................................................................................
..................................................................................................|...........
..................................................................................................|...........
..................................................................................................|...........
....................../#/............................................./#/.........................|.##........
......................###.............................................###.........................|.##........
....................../#/.........../#/.............................../#/.........................|.##........
.......................|............###................................|.......##HH#########/....-+-##........
.......................|............/#/................................|.......##..#####=#=##/....|.##........
.......................|.............|.................................|.......##..###########/...|.##........
.......................|.............|.................................|........|..|...########...|.##........
.......................|.............|.................................|........+--+...########...|.##........
.......................|.............|.................................|........|..|...########...|.##........
.......................|.............|.................................|........|..|...########..-+-##........
.......................|.............|.................................|........+--+...########...|.##........
......................###............|.......#################.###.....|........|..|..#########...|.##........
..................############.......|.######################################...|..|.##########...|...........
..............#######################H##########################################H##H###########...|...........
..............#######################=##########################################=##=#########=....|...........
..............#################################################################################...|...........
........#############################################################################################.........
........#############################################################################################.........
........#############################################################################################.........
..............#################################################################################...|...........
..............#################################################################################...|...........
..............#################################################################################...|...........
..............#################################################################################...|...........
..............#################################################################################...............
..............#################################################################################...............
(8,28),(8,31)|(14,25),(14,28)|(14,31),(14,37)|(18,24),(18,25)|(22,23),(22,24)|(25,23),(25,24)|(30,24),(30,25)|(37,27),(38,27)|(39,24),(39,25)|(45,23),(45,24)|(62,23),(62,24)|(63,23),(63,24)|(66,23),(66,24)|(77,24),(77,25)|(79,15),(79,18)|(80,27),(81,27)|(83,27),(84,27)|(85,24),(85,25)|(86,23),(86,24)|(87,18),(87,23)|(88,16),(88,17)|(89,16),(89,17)|(90,16),(90,17)|(91,16),(91,17)|(93,26),(93,27)|(95,26),(95,27)|(95,28),(95,31)|(95,37),(100,12)|(100,24),(101,28)|(101,31),(102,12)|
(100,12),(102,12)|(79,15),(88,16)|(89,16),(90,16)|(91,16),(88,17)|(89,17),(90,17)|(91,17),(79,18)|(87,18),(22,23)|(25,23),(45,23)|(62,23),(63,23)|(66,23),(86,23)|(87,23),(18,24)|(22,24),(25,24)|(30,24),(39,24)|(45,24),(62,24)|(63,24),(66,24)|(77,24),(85,24)|(86,24),(100,24)|(102,24),(14,25)|(18,25),(30,25)|(39,25),(77,25)|(85,25),(93,26)|(95,26),(37,27)|(38,27),(80,27)|(81,27),(83,27)|(84,27),(93,27)|(95,27),(8,28)|(14,28),(95,28)|(101,28),(8,31)|(14,31),(95,31)|(101,31),(14,37)|
(22,14),(23,15)|(24,12),(25,13)|(36,16),(37,17)|(38,14),(39,15)|(70,14),(71,15)|(72,12),(73,13)|(92,15),(95,18)|
(22,13),(23,12)|(24,15),(25,14)|(36,15),(37,14)|(38,17),(39,16)|(70,13),(71,12)|(72,15),(73,14)|
