Pièce : SI_D05
taille : 110x78
..............................................................................................................
..............................................................................................................
................................................|.............................................................
.......................|........................|............................................|................
.......................|........................#............................................|................
.......................|........................|............................................#................
.......................|........................|............................................|................
.......................|........................|............................................|................
.......................|........................|............................................|................
.......................|........................|............................................|......|.........
.......................|........................|............................................|......|.........
.......................|........................|............................................|......|.........
.......................|........................|............................................|......|.........
.......................|........................|............................................|......|.........
.................#.....|........................|............................................|......|.........
.........##.....###....|.....##.................|............................................|......|.........
.........##../############/..##..........##.....|............##..............................|......|.........
.........##..##############..##..........##../############/..##.......................##.....|......|....##...
.........##..##############..##..........##..##############..##............#..........##../###########/..##...
.........##..##############..##..........##..##############..##.........######........##..#############..##...
.........##..##############..##..........##..##############..##........########.......##..#############..##...
.........##--##############--##..........##..##############..##........########.......##..#############..##...
.........##..##############..##..........##--##############--##..........|.|.|........##..#############..##...
.........##--##############--##..........##..##############..##..........#.|.|........##--#############--##...
.........##..##############..##..........##--##############--##..........|.|.##.......##..#############..##...
.........##.....|..|.|..|....##..........##..##############..##............#.##.......##--#############--##...
...............##..|.##.|................##...|..|..|..|.....##....#|#.....#.|........##..#############..##...
...............##..#.|..#.....................#..|..|..##..........###.....|..........##....|..|..|..#...##...
................|..|.|........................|..#..##.|...........###.....|................#..|..#..|........
...................#.........................##..|..##.............###......................|.##..|..#........
...................#.............................|..##..............##......................#.##..##.|........
...................|.............................#..|...............##......................#..|..|...........
....................................................|...............##.........................#..|...........
....................................................|...............##.........................|..#...........
....................................................................##........................................
....................................................................##........................................
....................................................................##........................................
....................................................................##........................................
....................................................................##........................................
....................................................................##..................................|.....
....................................................................##..................................|.|...
....................................................................##..................................##/...
...............#....................................................##..................................###/..
....................................................................##..................................####..
....................................................................##..................................####-.
....................................................................##..................................####..
....................................................................##..................................####-.
....................................................................##..................................####..
....................................................................##..................................####-.
....................................###.............................##-.................................####..
..............................###########...........................##..................................####-.
.............................############...........................##..................................####..
..............................###########...........................##-.................................####-.
..............................###########...........................##.......................|..........####..
..#########..................############...........................##.......................|..........####-.
###########...................###########..........................###-......................|..|.......####..
###########...................###########..........................###.......................|..|.......####-.
###########..................############..........................###.......................####.......####..
###########...................###########....................|.....####....................../##/.......####..
###########...................###########....................|.....#####.....................|##|.......#####.
###########...................###########....................|.....####......................|..|.....########
###########....................|.......|.....................|.....#####.....................+--+...##########
###########....................|.......|.....................|.....#####.....................|..|...##########
##########.....................|.......|.....................|....##########.................|..|...##########
###########....................|.......|.....................|....##########.................####...##########
##########.....................|.......|.............######..|....##########................./##/...##########
###########.......######.......|.......|.............######..|...###########.................|..|...##########
############......######......#H#######H#............######..|...############................|..|..###########
##############....######......###########...........#######..|..##############...............|..|.############
#############################################################H################################################
##############################################################################################################
##############################################################################################################
##############################################################################################################
##############################################################################################################
##############################################################################################################
##############################################################################################################
##############################################################################################################
##############################################################################################################
