Pièce : SL_AI
taille : 98x35
#########..|...|..............................###########.............############################
######.|...|...#..............................#############...........############################
######.#...#...#..............................###############..........#####=#####################
######.|...|...|..............................################.........#####.#####################
##=###.|...|..................................################.........................../########
##.###.#......................................############..##............................/#######
##.###.#......................................############.................................#######
##.###.|......................................############.................................#######
##.###.|......................................#############................................#######
##.....|......................................################.............................#######
##.###.|.......................................###############.............................#######
##.#####........................................##############.............................#######
##.###########........................................########.............................#######
##.###########--...................................###########.............................#######
##.###########...................................#############.............................#######
##.###########.................................###############.............................#######
##.###.|......................................################.............................#######
##.###.|......................................################.............................#######
##.###.#......................................################.............................#######
##.###.|......................................################.............................#######
##.###.|......................................################.............................#######
##.###.|......................................##############...............................#######
##.###........................................##############...............................#######
##.###........................................###############..............................#######
##............................................##############...............................#######
######........................................###########..................................#######
########......................................#########....................................#######
###########......................................####......................................#######
###########--..............................................##.................####/........#######
###########..............................................#####............/########........#######
###########...........................................########............##########/......#######
######.|..........................................############/.........#############...../#######
######.|......................................##.##############/......./###############../########
##.....|......................................####################################################
##.###.|......................................####################################################
(2,4),(2,25)|(2,33),(2,35)|(3,4),(3,9)|(3,10),(3,24)|(3,34),(3,35)|(6,1),(6,9)|(6,10),(6,11)|(6,16),(6,24)|(6,25),(6,26)|(6,31),(6,33)|(6,34),(6,35)|(8,12),(8,26)|(8,27),(9,0)|(9,1),(11,27)|(11,31),(14,12)|(14,16),(46,0)|(46,10),(46,16)|(46,27),(46,32)|(46,35),(47,10)|(47,11),(47,15)|(47,16),(48,11)|(48,12),(48,32)|(48,33),(49,14)|(49,15),(49,27)|(49,28),(49,32)|(49,33),(50,31)|(50,32),(51,13)|(51,14),(53,27)|(53,28),(54,12)|(54,13),(54,30)|(54,31),(55,26)|(55,27),(57,0)|(57,1),(57,25)|(57,26),(57,29)|(57,30),(58,5)|(58,8),(59,1)|(59,2),(59,8)|(59,9),(59,28)|(59,29),(60,5)|(60,6),(60,21)|(60,23),(60,24)|(60,25),(61,2)|(61,3),(61,23)|(61,24),(61,28)|(61,29),(62,3)|(62,6),(62,9)|(62,21),(62,29)|(70,0),(70,2)|(71,2),(71,4)|(72,31),(74,31)|(76,2),(76,4)|(77,2),(77,4)|(78,28),(78,29)|(83,30),(85,32)|(87,32),(87,33)|
(9,0),(46,0)|(57,0),(70,0)|(6,1),(9,1)|(57,1),(59,1)|(59,2),(61,2)|(70,2),(71,2)|(76,2),(77,2)|(61,3),(62,3)|(2,4),(3,4)|(71,4),(76,4)|(77,4),(58,5)|(60,5),(60,6)|(62,6),(58,8)|(59,8),(3,9)|(6,9),(59,9)|(62,9),(3,10)|(6,10),(46,10)|(47,10),(6,11)|(47,11),(48,11)|(8,12),(14,12)|(48,12),(54,12)|(51,13),(54,13)|(49,14),(51,14)|(47,15),(49,15)|(6,16),(14,16)|(46,16),(47,16)|(60,21),(62,21)|(60,23),(61,23)|(3,24),(6,24)|(60,24),(61,24)|(2,25),(6,25)|(57,25),(60,25)|(6,26),(8,26)|(55,26),(57,26)|(8,27),(11,27)|(46,27),(49,27)|(53,27),(55,27)|(49,28),(53,28)|(59,28),(61,28)|(78,28),(57,29)|(59,29),(61,29)|(62,29),(78,29)|(54,30),(57,30)|(83,30),(6,31)|(11,31),(50,31)|(54,31),(72,31)|(74,31),(46,32)|(48,32),(49,32)|(50,32),(85,32)|(87,32),(2,33)|(6,33),(48,33)|(49,33),(87,33)|(3,34),(6,34)|(2,35),(3,35)|(6,35),(46,35)|