Pièce : SL_A11
taille : 48x35
################################################
################################################
###############################=################
###############################|################
##############################.|.###############
##############################.|.###############
##############################.|.###############
##############################.|.###############
##############################.|.###############
##############################.|.###############
##############################.|.###############
##############################.|.###############
##############################.|.###############
##############################...###############
##############################...###############
##############################...###############
##############################...###############
##############################...###############
##############################...###############
##############################...###############
##############################...###############
##############################...###############
###/................./########...###############
###...................########...###############
###...................########...###############
###...#############...########...###############
###...#############...########...###############
###...#############...########...###############
###################...########...###############
####=##############..............###############
###################..............###############
###################/............/###############
################################################
################################################
################################################
(3,28),(4,29)|(4,30),(5,29)|(5,30),(6,25)|(6,28),(19,25)|(22,29),(30,4)|(30,29),(31,2)|(32,2),(33,4)|
(31,2),(32,2)|(30,4),(33,4)|(6,25),(19,25)|(3,28),(6,28)|(4,29),(5,29)|(22,29),(30,29)|(4,30),(5,30)|
(19,31),(20,32)|(21,22),(22,23)|
(3,23),(4,22)|(32,32),(33,31)|
