Piece : SL_A08
54x35
-2489x167
######################################################
######################################################
#########=############################################
#########|############################################
########.|.###########################################
########.|.###########################################
########.|.###########################################
########.|.###########################################
######...|....######.....##....#........##############
######...|....######.....##....#........##############
######...|....#..###.....##....#######################
######...|....#...#......##.............##############
######...|........#......#############################
######...|........#......#############################
######..................................##############
######..................................##############
####=...................................##############
#######.................................##############
######...|....................................########
######...|........................##...........=######
######/..|..........#............#####........########
#######/.|......######.........########.##############
######################################################
######################################################
######################################################
######################################################
######################################################
######################################################
######################################################
######################################################
######################################################
######################################################
######################################################
######################################################
######################################################
(4,16),(4,17)|(6,8),(6,16)|(6,18),(6,20)|(7,17),(7,18)|(8,4),(8,8)|(9,2),(9,4)|(10,2),(10,4)|(11,4),(11,8)|(14,8),(14,12)|(15,10),(15,12)|(16,21),(16,22)|(17,10),(17,11)|(18,11),(18,14)|(19,11),(19,14)|(20,8),(20,11)|(20,20),(20,21)|(21,20),(21,21)|(22,21),(22,22)|(25,8),(25,14)|(27,8),(27,12)|(31,8),(31,11)|(31,21),(31,22)|(32,8),(32,10)|(33,20),(33,21)|(34,19),(34,20)|(36,19),(36,20)|(38,20),(38,21)|(39,21),(39,22)|(40,8),(40,10)|(40,11),(40,12)|(40,14),(40,18)|(40,21),(40,22)|(46,18),(46,19)|(46,20),(46,21)|(48,19),(48,20)|
(9,2),(10,2)|(8,4),(9,4)|(10,4),(11,4)|(6,8),(8,8)|(11,8),(14,8)|(20,8),(25,8)|(27,8),(31,8)|(32,8),(40,8)|(15,10),(17,10)|(32,10),(40,10)|(17,11),(18,11)|(19,11),(20,11)|(31,11),(40,11)|(14,12),(15,12)|(27,12),(40,12)|(18,14),(19,14)|(25,14),(40,14)|(4,16),(6,16)|(4,17),(7,17)|(6,18),(7,18)|(40,18),(46,18)|(34,19),(36,19)|(46,19),(48,19)|(6,20),(20,20)|(21,20),(33,20)|(34,20),(36,20)|(38,20),(46,20)|(16,21),(20,21)|(21,21),(22,21)|(31,21),(33,21)|(38,21),(39,21)|(40,21),(46,21)|(7.5,22),(8,22)|(16,22),(22,22)|(31,22),(39,22)|
(6,20),(8,22)|
None|
(9.5,3),(9.5,14)|(9.5,18),(9.5,22)|
None|
end file : SL_A08