Pièce : SL_B01
taille : 48x121
................................................
................................................
................................................
................................................
................................................
................................................
................................................
................................................
................................................
................................................
................................................
................................................
................................................
................................................
................................................
................................................
................................................
................................................
................................................
................................................
................................................
................................................
................................................
................................................
................................................
................................................
................................................
................................................
................................................
................................................
................................................
................................................
................................................
................................................
................................................
................................................
................................................
................................................
................................................
................................................
................................................
................................................
................................................
........................####....................
......................../##/....................
........................|##|....................
........................|..|....................
........................|..|....................
........|...............|..|....................
........|...............|..|....................
........#...............|..#....................
........#.......##############..................
........|........###########=...................
........|........###############................
........|..##...############....................
........|.##/....../######/.....................
........|##/......../#=##/......................
........###..........#|#........................
........##............||........................
.......##.............||........................
.......#####..........|.........................
.......#|.#...........|.........................
.......#|##...........|.........................
.........##.....................................
........|#......................................
........|#......................................
........|.......................................
......................|.........................
......................|.........................
......................|.........................
........|.............|.........................
........|.............|.........................
........|.............|.........................
........|.............|.........................
........|.............|.........................
.......#|.............#.........................
.......#|#...........####.......................
......##=#################......................
.---###################...-------...............
....###################.#####...................
...---#################|####--..................
........###..........##|#.......................
.........#.............|........................
.......................|........................
.......................|........................
.......................|........................
.......................|........................
.......................|........................
.......................|........................
................................................
..####..........................................
..#=##..........................................
..####..........................................
..####..........................................
..####..........................................
..####..........................................
..####..........................................
..####..........................................
..####..........................................
..####..........................................
..####..........................................
..####..........#|#.............................
..####..........###.............................
..####..........###.....................####....
.###########....###.....................##=#....
#############|#.###.....................####....
#############=#####................####.#####...
#####################............##############.
###########################.####################
###########################=####################
################################################
################################################
################################################
################################################
################################################
################################################
################################################
################################################
################################################
################################################
################################################
0,105|1,104|1,105|2,90|2,104|3,91|3,92|4,91|4,92|6,77|6,78|6,90|6,104|7,59|7,63|7,75|7,77|8,59|8,78|8,81|8,82|9,59|9,60|9,78|9,82|9,83|10,55|10,56|10,58|10,59|10,61|10,62|10,64|10,66|10,76|10,77|10,82|10,83|11,54|11,55|11,57|11,58|11,61|11,64|11,81|11,82|12,60|12,61|12,104|12,105|13,54|13,55|13,107|14,107|15,105|15,106|16,51|16,52|16,54|16,55|16,101|16,106|17,52|17,54|19,55|19,101|19,107|21,57|21,58|21,76|21,77|21,81|21,82|21,107|21,108|22,56|22,76|23,56|23,76|23,78|24,43|24,44|24,57|24,79|25,45|25,57|25,76|25,77|25,81|25,82|26,77|27,45|27,51|27,55|27,108|27,110|28,43|28,44|28,51|28,52|28,53|28,54|28,55|28,108|28,110|30,51|30,52|32,53|32,54|33,107|33,108|35,106|35,107|39,106|39,107|40,103|40,107|42,104|42,105|43,104|43,105|44,103|44,106|45,106|45,107|47,107|47,108|48,108|
(0,105),(1,104)|(1,105),(2,90)|(2,104),(3,91)|(3,92),(4,91)|(4,92),(6,77)|(6,78),(6,90)|(6,104),(7,59)|(7,63),(7,75)|(7,77),(8,59)|(8,78),(8,81)|(8,82),(9,59)|(9,60),(9,78)|(9,82),(9,83)|(10,55),(10,56)|(10,58),(10,59)|(10,61),(10,62)|(10,64),(10,66)|(10,76),(10,77)|(10,82),(10,83)|(11,54),(11,55)|(11,57),(11,58)|(11,61),(11,64)|(11,81),(11,82)|(12,60),(12,61)|(12,104),(12,105)|(13,54),(13,55)|(13,107),(14,107)|(15,105),(15,106)|(16,51),(16,52)|(16,54),(16,55)|(16,101),(16,106)|(17,52),(17,54)|(19,55),(19,101)|(19,107),(21,57)|(21,58),(21,76)|(21,77),(21,81)|(21,82),(21,107)|(21,108),(22,56)|(22,76),(23,56)|(23,76),(23,78)|(24,43),(24,44)|(24,57),(24,79)|(25,45),(25,57)|(25,76),(25,77)|(25,81),(25,82)|(26,77),(27,45)|(27,51),(27,55)|(27,108),(27,110)|(28,43),(28,44)|(28,51),(28,52)|(28,53),(28,54)|(28,55),(28,108)|(28,110),(30,51)|(30,52),(32,53)|(32,54),(33,107)|(33,108),(35,106)|(35,107),(39,106)|(39,107),(40,103)|(40,107),(42,104)|(42,105),(43,104)|(43,105),(44,103)|(44,106),(45,106)|(45,107),(47,107)|(47,108),(48,108)|
(24,43),(28,43)|(24,44),(28,44)|(25,45),(27,45)|(16,51),(27,51)|(28,51),(30,51)|(16,52),(17,52)|(28,52),(30,52)|(28,53),(32,53)|(11,54),(13,54)|(16,54),(17,54)|(28,54),(32,54)|(10,55),(11,55)|(13,55),(16,55)|(19,55),(27,55)|(28,55),(10,56)|(22,56),(23,56)|(11,57),(21,57)|(24,57),(25,57)|(10,58),(11,58)|(21,58),(7,59)|(8,59),(9,59)|(10,59),(9,60)|(12,60),(10,61)|(11,61),(12,61)|(10,62),(7,63)|(10,64),(11,64)|(10,66),(7,75)|(10,76),(21,76)|(22,76),(23,76)|(25,76),(6,77)|(7,77),(10,77)|(21,77),(25,77)|(26,77),(6,78)|(8,78),(9,78)|(23,78),(24,79)|(8,81),(11,81)|(21,81),(25,81)|(8,82),(9,82)|(10,82),(11,82)|(21,82),(25,82)|(9,83),(10,83)|(2,90),(6,90)|(3,91),(4,91)|(3,92),(4,92)|(16,101),(19,101)|(40,103),(44,103)|(1,104),(2,104)|(6,104),(12,104)|(42,104),(43,104)|(0,105),(1,105)|(12,105),(15,105)|(42,105),(43,105)|(15,106),(16,106)|(35,106),(39,106)|(44,106),(45,106)|(13,107),(14,107)|(19,107),(21,107)|(33,107),(35,107)|(39,107),(40,107)|(45,107),(47,107)|(21,108),(27,108)|(28,108),(33,108)|(47,108),(48,108)|(27,110),(28,110)|