Pièce : SL_B04
48x121
123x399
................................................
................................................
................................................
................................................
................................................
................................................
................................................
................................................
................................................
................................................
..................###...........................
..................###......###..................
..................###......###....#HH#..........
...........###.....|.......###....|..|..........
...........###.....|........|.....|..|..........
...........###.....|........|.....+--+..........
............|......|........|.....|..|..........
............|......|........|.....|..|..........
............|......|........|.....+--+..........
............|......#........|.....#..|..........
............|....#####......|....##..#..........
........###HH###############H######HH####.......
.......####..#=########=####=######..####.......
.......####..######################..####.......
.......####--######################--####.......
.......####..######################..###........
........###..######################..###........
..........#--######################--#..........
..........#..######################..#..........
..........#..###################..#..#..........
..........#--###################..#-.#..........
.............###################..#..#..........
.............###################..#..#..........
...........--###################..#--#..........
..............##################..#..#..........
..............##################..#..#..........
..............##################..#--#..........
..............##################..#..#..........
..............##################..|..#..........
..............##################..+--#..........
..............##################..|..#..........
..............##################..|.............
..............##################..+.............
..............##################..|.............
................################..|.............
................################..|.............
................################..|.............
................################................
................################................
................################................
................################................
................################..|.............
................################..|.............
................################..|.............
................################..|.............
................################..#.............
................#################.#.............
................########################........
................#################=#..###........
................###################..###........
................###################--###........
................###################..###........
................################..#..#..........
................################..#--#..........
................################..#..#..........
................################..#.............
................################..#-............
................################..#.............
................################................
................################................
................################................
................################................
................################................
................################................
................################................
................################................
................################................
................################................
................################................
................################................
................################................
................################................
................################................
................################................
................################................
................################................
................################................
................################................
................################................
................################................
................################................
................################................
................################................
................################................
................################................
................################................
................################................
................################................
................################................
................################................
................################................
................################................
................################................
................################................
................################................
................################................
................################................
................################................
................################................
................################................
................################................
................################................
................################................
................################................
................################................
................################................
................################................
................################................
................################................
................################................
................################................
(7,22),(7,26)|(8,21),(8,22)|(8,26),(8,27)|(10,27),(10,31)|(11,13),(11,16)|(11,21),(11,31)|(13,21),(13,34)|(14,13),(14,16)|(14,22),(14,23)|(14,34),(14,44)|(15,22),(15,23)|(16,44),(16,121)|(17,20),(17,21)|(18,10),(18,13)|(19,19),(19,20)|(20,19),(20,20)|(21,10),(21,13)|(22,20),(22,21)|(23,22),(23,23)|(24,22),(24,23)|(27,11),(27,14)|(28,21),(28,23)|(29,21),(29,23)|(30,11),(30,14)|(32,29),(32,56)|(32,62),(32,121)|(33,20),(33,21)|(33,56),(33,57)|(33,58),(33,59)|(34,12),(34,13)|(34,19),(34,20)|(34,29),(34,38)|(34,55),(34,57)|(34,58),(34,59)|(34,62),(34,68)|(35,12),(35,13)|(35,19),(35,38)|(35,55),(35,57)|(35,58),(35,68)|(37,12),(37,13)|(37,20),(37,41)|(37,58),(37,65)|(38,12),(38,13)|(38,20),(38,21)|(38,27),(38,41)|(38,62),(38,65)|(40,25),(40,27)|(40,57),(40,62)|(41,21),(41,25)|
(18,10),(21,10)|(27,11),(30,11)|(34,12),(35,12)|(37,12),(38,12)|(11,13),(14,13)|(18,13),(21,13)|(34,13),(35,13)|(37,13),(38,13)|(27,14),(30,14)|(11,16),(14,16)|(19,19),(20,19)|(34,19),(35,19)|(17,20),(19,20)|(20,20),(22,20)|(33,20),(34,20)|(37,20),(38,20)|(8,21),(11,21)|(13,21),(17,21)|(22,21),(28,21)|(29,21),(33,21)|(38,21),(41,21)|(7,22),(8,22)|(14,22),(15,22)|(23,22),(24,22)|(14,23),(15,23)|(23,23),(24,23)|(28,23),(29,23)|(40,25),(41,25)|(7,26),(8,26)|(8,27),(10,27)|(38,27),(40,27)|(32,29),(34,29)|(10,31),(11,31)|(13,34),(14,34)|(34,38),(35,38)|(37,41),(38,41)|(14,44),(16,44)|(34,55),(35,55)|(32,56),(33,56)|(33,57),(34,57)|(35,57),(40,57)|(33,58),(34,58)|(35,58),(37,58)|(33,59),(34,59)|(32,62),(34,62)|(38,62),(40,62)|(37,65),(38,65)|(34,68),(35,68)|(16,121),(32,121)|


(12.5,16),(12.5,21)|(19.5,13),(19.5,19)|(28.5,14),(28.5,21)|(34.5,13),(34.5,19)|(34.5,38),(34.5,47)|(34.5,51),(34.5,55)|(37.5,13),(37.5,20)|
(34,15.5),(38,15.5)|(34,18.5),(38,18.5)|(11,24.5),(13,24.5)|(35,24.5),(37,24.5)|(11,27.5),(13,27.5)|(35,27.5),(37,27.5)|(11,30.5),(13,30.5)|(35,30.5),(36,30.5)|(11,33.5),(13,33.5)|(35,33.5),(37,33.5)|(35,36.5),(37,36.5)|(34,39.5),(37,39.5)|(34,42.5),(35,42.5)|(35,60.5),(37,60.5)|(35,63.5),(37,63.5)|(35,66.5),(36,66.5)|
end file : SL_B04