Pièce : SL_C07
taille : 48x121
################################################
################################################
################################################
################################################
################################################
################################################
################################################
################################################
####################=######=####################
####################|######|####################
###################.|......|.###################
###################.|......|.###################
#################=..#......|.###################
######################.....|.###################
#####################......#####################
###################..........###################
###################..........###################
###################..........###################
###################........#.###################
#################=.........#####################
######################H##H######################
###################...|..|...###################
###################...+--+...###################
###################...|..|...###################
###################...|..|...###################
###################...+--|...###################
###################...|..|...###################
###################...|..|...###################
###################...+..+...###################
###################...|..|...###################
###################...|..|...###################
###################...+--+...###################
###################...|..|...###################
###################...|..|...###################
###################...+--+...###################
###################...|..|...###################
###################...|..|...###################
###################...+.-+...###################
###################...|..|...###################
###################...|..|...###################
###################...|.-+...###################
###################...|......###################
###################...|......###################
###################...+......###################
###################...|......###################
###################...|......###################
###################..........###################
###################..........###################
###################..........###################
###################..........###################
###################...|......###################
###################...|......###################
###################...+-.....###################
###################...|..|...###################
###################...|..|...###################
###################...+--+...###################
###################...|..|...###################
###################...|..|...###################
###################...+--+...###################
###################...|..|...###################
###################...|..|...###################
###################...+.-+...###################
###################...|..|...###################
###################......|...###################
###################....--+...###################
###################......|...###################
###################......|...###################
###################.....-+...###################
###################......|...###################
###################......|...###################
###################......+...###################
###################...|..|...###################
###################...|..|...###################
###################...+-.|...###################
###################...|..|...###################
###################...|..|...###################
###################...+--+...###################
###################...|..|...###################
###################...|..|...###################
###################...+--+...###################
###################...|..|....=#################
###################...|..|...###################
#######################HH#######################
#######################..#######################
##################/...#..#.../##################
#################/....#--#..../#################
################/.....#..#...../################
###...........#.......#..#........#..........###
#=............#.......#--#........#...........=#
###...........#.......#..#........#..........###
#=....................#..#........#...........=#
###...................#--#........#..........###
#=....................#..#....................=#
###...................#..#...................###
#=............#.......+--+........#...........=#
###...........#.......|..|........#..........###
################/.....|..|...../################
#######...#######/....+--+..../#######...#######
#######...########/...|..|.../########...#######
#######...#########...|..|...#########...#######
#######...#########.....-+...#########...#######
#######...#########......|...#########...#######
#######...#########......|...#########...#######
#######...#########......+...#########...#######
########.##########......|...#########...#######
########=##########..........#########...#######
###################..........#########...#######
###################..........#########...#######
####################........###########.########
######################.....############=########
################################################
######################=#=#=#####################
################################################
################################################
################################################
################################################
################################################
################################################
################################################
################################################
################################################
29,10|19,12|21,14|21,13|20,13|22,14|22,13|19,15|21,15|27,15|29,15|29,14|19,19|28,18|27,18|28,19|29,19|19,21|27,20|29,21|29,80|29,81|19,82|29,82|22,84|26,84|19,84|29,84|3,87|15,87|14,87|16,87|32,87|35,87|34,87|45,87|3,88|45,88|3,90|3,89|15,90|14,90|45,90|45,89|3,92|3,91|35,92|34,92|45,92|45,91|3,94|3,93|45,94|45,93|15,94|14,94|35,94|34,94|3,95|45,95|3,96|7,97|10,97|15,96|14,96|16,96|32,96|35,96|34,96|38,97|41,97|45,96|19,99|29,99|7,104|8,104|9,104|10,104|19,108|20,108|28,108|29,108|38,108|39,108|40,108|41,108|20,109|22,109|27,109|28,109|22,110|27,110|