Piece : SL_C07
48x121
1343x-208
################################################
################################################
################################################
################################################
################################################
################################################
################################################
################################################
####################=######=####################
####################|######|####################
###################.|......|.###################
###################.|......|.###################
#################=..#......|.###################
######################.....|.###################
#####################......#####################
###################..........###################
###################..........###################
###################..........###################
###################........#.###################
#################=.........#####################
######################H##H######################
###################...|..|...###################
###################...+--+...###################
###################...|..|...###################
###################...|..|...###################
###################...+--|...###################
###################...|..|...###################
###################...|..|...###################
###################...+..+...###################
###################...|..|...###################
###################...|..|...###################
###################...+--+...###################
###################...|..|...###################
###################...|..|...###################
###################...+--+...###################
###################...|..|...###################
###################...|..|...###################
###################...+.-+...###################
###################...|..|...###################
###################...|..|...###################
###################...|.-+...###################
###################...|......###################
###################...|......###################
###################...+......###################
###################...|......###################
###################...|......###################
###################..........###################
###################..........###################
###################..........###################
###################..........###################
###################...|......###################
###################...|......###################
###################...+-.....###################
###################...|..|...###################
###################...|..|...###################
###################...+--+...###################
###################...|..|...###################
###################...|..|...###################
###################...+--+...###################
###################...|..|...###################
###################...|..|...###################
###################...+.-+...###################
###################...|..|...###################
###################......|...###################
###################....--+...###################
###################......|...###################
###################......|...###################
###################.....-+...###################
###################......|...###################
###################......|...###################
###################......+...###################
###################...|..|...###################
###################...|..|...###################
###################...+-.|...###################
###################...|..|...###################
###################...|..|...###################
###################...+--+...###################
###################...|..|...###################
###################...|..|...###################
###################...+--+...###################
###################...|..|....=#################
###################...|..|...###################
#######################HH#######################
#######################..#######################
##################/...#..#.../##################
#################/....#--#..../#################
################/.....#..#...../################
###...........#.......#..#........#..........###
#=............#.......#--#........#...........=#
###...........#.......#..#........#..........###
#=....................#..#........#...........=#
###...................#--#........#..........###
#=....................#..#....................=#
###...................#..#...................###
#=............#.......+--+........#...........=#
###...........#.......|..|........#..........###
################/.....|..|...../################
#######...#######/....+--+..../#######...#######
#######...########/...|..|.../########...#######
#######...#########...|..|...#########...#######
#######...#########.....-+...#########...#######
#######...#########......|...#########...#######
#######...#########......|...#########...#######
#######...#########......+...#########...#######
########.##########......|...#########...#######
########=##########..........#########...#######
###################..........#########...#######
###################..........#########...#######
####################........###########.########
######################.....############=########
################################################
######################=#=#=#####################
################################################
################################################
################################################
################################################
################################################
################################################
################################################
################################################
################################################
(1,88),(1,89)|(1,90),(1,91)|(1,92),(1,93)|(1,94),(1,95)|(3,87),(3,88)|(3,89),(3,90)|(3,91),(3,92)|(3,93),(3,94)|(3,95),(3,96)|(7,97),(7,104)|(8,104),(8,106)|(9,104),(9,106)|(10,97),(10,104)|(14,87),(14,90)|(14,94),(14,96)|(15,87),(15,90)|(15,94),(15,96)|(17,12),(17,13)|(17,19),(17,20)|(19,10),(19,12)|(19,15),(19,19)|(19,21),(19,82)|(19,84),(19,99)|(20,8),(20,10)|(20,12),(20,13)|(20,108),(20,109)|(21,8),(21,10)|(21,12),(21,13)|(21,14),(21,15)|(22,13),(22,14)|(22,20),(22,21)|(22,84),(22,94)|(22,109),(22,110)|(22,111),(22,112)|(23,20),(23,21)|(23,82),(23,94)|(23,111),(23,112)|(24,111),(24,112)|(25,20),(25,21)|(25,82),(25,94)|(25,111),(25,112)|(26,20),(26,21)|(26,84),(26,94)|(26,111),(26,112)|(27,8),(27,10)|(27,14),(27,15)|(27,18),(27,20)|(27,109),(27,110)|(27,111),(27,112)|(28,8),(28,10)|(28,18),(28,19)|(28,108),(28,109)|(29,10),(29,14)|(29,15),(29,19)|(29,21),(29,80)|(29,81),(29,82)|(29,84),(29,99)|(31,80),(31,81)|(34,87),(34,92)|(34,94),(34,96)|(35,87),(35,92)|(35,94),(35,96)|(38,97),(38,108)|(39,108),(39,110)|(40,108),(40,110)|(41,97),(41,108)|(45,87),(45,88)|(45,89),(45,90)|(45,91),(45,92)|(45,93),(45,94)|(45,95),(45,96)|(47,88),(47,89)|(47,90),(47,91)|(47,92),(47,93)|(47,94),(47,95)|
(20,8),(21,8)|(27,8),(28,8)|(19,10),(20,10)|(21,10),(27,10)|(28,10),(29,10)|(17,12),(19,12)|(20,12),(21,12)|(17,13),(20,13)|(21,13),(22,13)|(21,14),(22,14)|(27,14),(29,14)|(19,15),(21,15)|(27,15),(29,15)|(27,18),(28,18)|(17,19),(19,19)|(28,19),(29,19)|(17,20),(22,20)|(23,20),(25,20)|(26,20),(27,20)|(19,21),(22,21)|(23,21),(25,21)|(26,21),(29,21)|(29,80),(31,80)|(29,81),(31,81)|(19,82),(23,82)|(25,82),(29,82)|(19,84),(22,84)|(26,84),(29,84)|(3,87),(14,87)|(15,87),(16,87)|(32,87),(34,87)|(35,87),(45,87)|(1,88),(3,88)|(45,88),(47,88)|(1,89),(3,89)|(45,89),(47,89)|(1,90),(3,90)|(14,90),(15,90)|(45,90),(47,90)|(1,91),(3,91)|(45,91),(47,91)|(1,92),(3,92)|(34,92),(35,92)|(45,92),(47,92)|(1,93),(3,93)|(45,93),(47,93)|(1,94),(3,94)|(14,94),(15,94)|(22,94),(23,94)|(25,94),(26,94)|(34,94),(35,94)|(45,94),(47,94)|(1,95),(3,95)|(45,95),(47,95)|(3,96),(14,96)|(15,96),(16,96)|(32,96),(34,96)|(35,96),(45,96)|(7,97),(10,97)|(38,97),(41,97)|(7,104),(8,104)|(9,104),(10,104)|(8,106),(9,106)|(19,108),(20,108)|(28,108),(29,108)|(38,108),(39,108)|(40,108),(41,108)|(20,109),(22,109)|(27,109),(28,109)|(22,110),(27,110)|(39,110),(40,110)|(22,111),(23,111)|(24,111),(25,111)|(26,111),(27,111)|(22,112),(23,112)|(24,112),(25,112)|(26,112),(27,112)|
(16,96),(19,99)|(29,84),(32,87)|
(16,87),(19,84)|(29,99),(32,96)|
(20.5,9),(20.5,12)|(22.5,21),(22.5,46)|(22.5,50),(22.5,63)|(22.5,71),(22.5,82)|(22.5,94),(22.5,100)|(25.5,21),(25.5,41)|(25.5,53),(25.5,82)|(25.5,94),(25.5,105)|(27.5,9),(27.5,14)|
(22,22.5),(26,22.5)|(22,25.5),(25,25.5)|(22,28.5),(23,28.5)|(25,28.5),(26,28.5)|(22,31.5),(26,31.5)|(22,34.5),(26,34.5)|(22,37.5),(23,37.5)|(24,37.5),(26,37.5)|(24,40.5),(26,40.5)|(22,43.5),(23,43.5)|(22,52.5),(24,52.5)|(22,55.5),(26,55.5)|(22,58.5),(26,58.5)|(22,61.5),(23,61.5)|(24,61.5),(26,61.5)|(23,64.5),(26,64.5)|(24,67.5),(26,67.5)|(25,70.5),(26,70.5)|(22,73.5),(24,73.5)|(22,76.5),(26,76.5)|(22,79.5),(26,79.5)|(23,85.5),(25,85.5)|(23,88.5),(25,88.5)|(23,91.5),(25,91.5)|(22,94.5),(26,94.5)|(22,97.5),(26,97.5)|(24,100.5),(26,100.5)|(25,103.5),(26,103.5)|
end file : SL_C07