Pièce : SL_E02
taille : 258x35
##################################################################################################################################################################################################################################################################
##################################################################################################################################################################################################################################################################
#######################....##########################################################################################################################################...####..##.#####.#...####...#.#####.##..####..##.#####.../################=#################
#########..#########..........######...|...###########################################################################/..................../#########################...####..##########...####...#.########..####..############################|#################
#######=...#########..........######...|....=#########################################################################......................#########################...####..########.....####...##########..####..###########################.|.################
#########..#########..........######...|...###########################################################################......................#########################............#####..............#####..............#####....../############.|.################
#########--#########..........#########H##############################################################################...################...########################/..............#..................#..................#........./###########.|.################
#########..#########..........######...|...###########################################################################...################...#######################/.....................................................#........../##########.|.################
#########..#########..........######...|...###########################################################################...################...######################/......................................................#.........../#########.|.################
#########--########/........../#####...|...###########################################################################...################...#####################/..................................................................../########.|.################
#########..#######/............/####...|...###########################################################################...################...####################/..................#.................................................../#######.|.################
####....|..|...#...................|...|...|....#...................#...................#...................#...................#..................................................#..................#..................................#......|......###########
##=.....+--+.......................|...|...|....#.......................................#.......................................#..................................................#..................#..................#...............#......|.......=#########
####....|..|.......................|...|...|............................................#.......................................#..................................................#..................#..................#...............#......|......###########
##=.....|..|.......................|...|...|............................................#...........................................................#............................#####..............#####..............#####.............#......|.......=#########
####...............................#########........................#...................#...................#.......................................#............................#####..............#####..............#####.............#....#####....###########
##=................................#########........................#...................#...................#.......................................#............................#####..............#####..............#####.............#....#####.....=#########
####................................................................#...................#...................#.......................................#............................#####..............#####..............#####..................|...|....###########
##=.....#......#................................#................#..#.......................................#.......................................#............................#####..............#####..............#####..................|...|.....=#########
####..####.....#................................#..............###..#.................................##....#...................#......##...##......#..............................#..................#..................#...............#....|...|....###########
##################/............/#########################################################################################################...####################...................#..................#..................#............./#######...################
###################/........../##########################################################################################################...####################...................#..................#..................#............/########...################
####################..........###########################################################################################################...####################...................#.....................................#.........../#########...################
####################..........###########################################################################################################...####################...................#.....................................#........../##########...################
####################..........###########################################################################################################...####################.......................................................########################...################
####################..........###########################################################################################################...####################.......................................................########################...################
####################..........###########################################################################################################...####################......................................#................########################...################
####################..........###########################################################################################################...####################...................#..................#................########################...################
####################..........###########################################################################################################........................................#####..............#####.........................................################
####################..........###########################################################################################################........................................#####..............#####.........................................################
####################..........###########################################################################################################/.........................#.............######.............######......................................./################
####################..........##################################################################################################################################..###.........##.#######............#######............###########################################
########################.#.#.#####################################################################################################################################################################################################################################
########################=#=#=##########################################################################################################################################=#=#=###############=#=#=#############=#=#=################################################
##################################################################################################################################################################################################################################################################
(2,12),(2,13)|(2,14),(2,15)|(2,16),(2,17)|(2,18),(2,19)|(4,11),(4,12)|(4,13),(4,14)|(4,15),(4,16)|(4,17),(4,18)|(4,19),(4,20)|(6,19),(6,20)|(7,4),(7,5)|(8,18),(8,19)|(9,3),(9,4)|(9,5),(9,18)|(9,19),(10,19)|(10,20),(11,3)|(15,11),(15,12)|(15,18),(15,20)|(16,11),(16,12)|(16,18),(16,20)|(20,3),(20,32)|(23,2),(23,3)|(24,32),(24,34)|(25,32),(25,34)|(26,32),(26,34)|(27,2),(27,3)|(27,32),(27,34)|(28,32),(28,34)|(29,32),(29,34)|(30,3),(30,32)|(35,17),(36,3)|(36,6),(36,7)|(43,3),(43,4)|(43,5),(43,6)|(43,7),(44,17)|(45,4),(45,5)|(48,11),(48,13)|(48,18),(48,20)|(49,11),(49,13)|(49,18),(49,20)|(63,19),(63,20)|(65,18),(65,19)|(66,18),(66,20)|(68,11),(68,12)|(68,15),(68,20)|(69,11),(69,12)|(69,15),(69,20)|(88,11),(88,18)|(89,11),(89,18)|(102,19),(102,20)|(104,19),(104,20)|(108,11),(108,12)|(108,15),(108,20)|(109,11),(109,12)|(109,15),(109,20)|(118,11),(121,6)|(121,11),(128,11)|(128,14),(128,19)|(128,20),(129,11)|(129,14),(129,19)|(129,20),(135,19)|(135,20),(137,6)|(137,11),(137,19)|(140,11),(140,19)|(140,28),(142,19)|(142,20),(148,14)|(148,20),(149,14)|(149,20),(160,20)|(160,28),(160,31)|(160,32),(162,31)|(162,32),(163,30)|(163,31),(164,30)|(164,31),(165,2)|(165,31),(165,32)|(167,33),(167,34)|(168,2),(168,5)|(168,33),(168,34)|(169,33),(169,34)|(170,33),(170,34)|(171,33),(171,34)|(172,2),(172,5)|(172,33),(172,34)|(174,2),(174,5)|(174,31),(174,32)|(176,2),(176,3)|(176,31),(176,32)|(177,2),(177,3)|(177,5),(177,6)|(177,14),(177,19)|(177,28),(177,32)|(179,6),(179,7)|(179,10),(179,14)|(179,19),(179,24)|(179,27),(179,28)|(180,6),(180,7)|(180,10),(180,14)|(180,19),(180,24)|(180,27),(180,28)|(182,2),(182,3)|(182,4),(182,6)|(182,14),(182,19)|(182,28),(182,30)|(183,2),(183,3)|(183,30),(183,31)|(184,2),(184,4)|(184,31),(184,32)|(187,2),(187,5)|(187,33),(187,34)|(188,33),(188,34)|(189,33),(189,34)|(190,33),(190,34)|(191,2),(191,5)|(191,33),(191,34)|(192,33),(192,34)|(194,2),(194,5)|(195,2),(195,4)|(196,2),(196,4)|(196,5),(196,6)|(196,14),(196,19)|(196,28),(196,32)|(198,6),(198,7)|(198,11),(198,14)|(198,19),(198,22)|(198,26),(198,28)|(199,6),(199,7)|(199,11),(199,14)|(199,19),(199,22)|(199,26),(199,28)|(201,2),(201,3)|(201,5),(201,6)|(201,14),(201,19)|(201,28),(201,30)|(202,2),(202,3)|(202,30),(202,31)|(203,31),(203,32)|(204,2),(204,5)|(205,33),(205,34)|(206,2),(206,5)|(206,33),(206,34)|(207,33),(207,34)|(208,33),(208,34)|(209,33),(209,34)|(210,2),(210,5)|(210,33),(210,34)|(212,2),(212,5)|(214,2),(214,3)|(215,2),(215,3)|(215,5),(215,6)|(215,14),(215,19)|(215,24),(215,28)|(215,31),(215,32)|(217,6),(217,9)|(217,12),(217,14)|(217,19),(217,24)|(218,6),(218,9)|(218,12),(218,14)|(218,19),(218,24)|(220,2),(220,3)|(220,5),(220,6)|(220,14),(220,19)|(233,11),(233,17)|(233,19),(233,20)|(234,11),(234,17)|(234,19),(234,20)|(238,15),(239,4)|(239,11),(239,28)|(240,2),(241,2)|(242,4),(242,11)|(243,15),(247,11)|(247,12),(247,13)|(247,14),(247,15)|(247,16),(247,17)|(247,18),(247,19)|(247,20),(249,12)|(249,13),(249,14)|(249,15),(249,16)|(249,17),(249,18)|
(23,2),(27,2)|(165,2),(168,2)|(172,2),(174,2)|(176,2),(177,2)|(182,2),(183,2)|(184,2),(187,2)|(191,2),(194,2)|(195,2),(196,2)|(201,2),(202,2)|(204,2),(206,2)|(210,2),(212,2)|(214,2),(215,2)|(220,2),(240,2)|(241,2),(9,3)|(11,3),(20,3)|(23,3),(27,3)|(30,3),(36,3)|(43,3),(176,3)|(177,3),(182,3)|(183,3),(201,3)|(202,3),(214,3)|(215,3),(220,3)|(7,4),(9,4)|(43,4),(45,4)|(182,4),(184,4)|(195,4),(196,4)|(239,4),(242,4)|(7,5),(9,5)|(43,5),(45,5)|(168,5),(172,5)|(174,5),(177,5)|(187,5),(191,5)|(194,5),(196,5)|(201,5),(204,5)|(206,5),(210,5)|(212,5),(215,5)|(220,5),(36,6)|(43,6),(121,6)|(137,6),(177,6)|(179,6),(180,6)|(182,6),(196,6)|(198,6),(199,6)|(201,6),(215,6)|(217,6),(218,6)|(220,6),(36,7)|(43,7),(179,7)|(180,7),(198,7)|(199,7),(217,9)|(218,9),(179,10)|(180,10),(4,11)|(15,11),(16,11)|(48,11),(49,11)|(68,11),(69,11)|(88,11),(89,11)|(108,11),(109,11)|(118,11),(121,11)|(128,11),(129,11)|(137,11),(140,11)|(198,11),(199,11)|(233,11),(234,11)|(239,11),(242,11)|(247,11),(2,12)|(4,12),(15,12)|(16,12),(68,12)|(69,12),(108,12)|(109,12),(217,12)|(218,12),(247,12)|(249,12),(2,13)|(4,13),(48,13)|(49,13),(247,13)|(249,13),(2,14)|(4,14),(128,14)|(129,14),(148,14)|(149,14),(177,14)|(179,14),(180,14)|(182,14),(196,14)|(198,14),(199,14)|(201,14),(215,14)|(217,14),(218,14)|(220,14),(247,14)|(249,14),(2,15)|(4,15),(68,15)|(69,15),(108,15)|(109,15),(238,15)|(243,15),(247,15)|(249,15),(2,16)|(4,16),(247,16)|(249,16),(2,17)|(4,17),(35,17)|(44,17),(233,17)|(234,17),(247,17)|(249,17),(2,18)|(4,18),(8,18)|(9,18),(15,18)|(16,18),(48,18)|(49,18),(65,18)|(66,18),(88,18)|(89,18),(247,18)|(249,18),(2,19)|(4,19),(6,19)|(8,19),(9,19)|(10,19),(63,19)|(65,19),(102,19)|(104,19),(128,19)|(129,19),(135,19)|(137,19),(140,19)|(142,19),(177,19)|(179,19),(180,19)|(182,19),(196,19)|(198,19),(199,19)|(201,19),(215,19)|(217,19),(218,19)|(220,19),(233,19)|(234,19),(247,19)|(249,19),(4,20)|(6,20),(10,20)|(15,20),(16,20)|(48,20),(49,20)|(63,20),(66,20)|(68,20),(69,20)|(102,20),(104,20)|(108,20),(109,20)|(128,20),(129,20)|(135,20),(142,20)|(148,20),(149,20)|(160,20),(233,20)|(234,20),(247,20)|(198,22),(199,22)|(179,24),(180,24)|(215,24),(217,24)|(218,24),(198,26)|(199,26),(179,27)|(180,27),(140,28)|(160,28),(177,28)|(179,28),(180,28)|(182,28),(196,28)|(198,28),(199,28)|(201,28),(215,28)|(239,28),(163,30)|(164,30),(182,30)|(183,30),(201,30)|(202,30),(160,31)|(162,31),(163,31)|(164,31),(165,31)|(174,31),(176,31)|(183,31),(184,31)|(202,31),(203,31)|(215,31),(20,32)|(24,32),(25,32)|(26,32),(27,32)|(28,32),(29,32)|(30,32),(160,32)|(162,32),(165,32)|(174,32),(176,32)|(177,32),(184,32)|(196,32),(203,32)|(215,32),(167,33)|(168,33),(169,33)|(170,33),(171,33)|(172,33),(187,33)|(188,33),(189,33)|(190,33),(191,33)|(192,33),(205,33)|(206,33),(207,33)|(208,33),(209,33)|(210,33),(24,34)|(25,34),(26,34)|(27,34),(28,34)|(29,34),(167,34)|(168,34),(169,34)|(170,34),(171,34)|(172,34),(187,34)|(188,34),(189,34)|(190,34),(191,34)|(192,34),(205,34)|(206,34),(207,34)|(208,34),(209,34)|
(18,20),(20,22)|(30,9),(32,11)|(137,30),(138,31)|(139,3),(140,4)|(226,5),(232,11)|
(18,11),(20,9)|(30,22),(32,20)|(118,4),(119,3)|(160,11),(165,6)|(223,3),(224,2)|(228,24),(232,20)|(241,31),(242,30)|
