Pièce : SL_E01
taille : 48x207
################################################
################################################
###############=#.#.###.#.#|#.##=###############
###############|#.#.#|#.#.#|#.##|###############
#############/.|.....|.....|....|./#############
#############..|.....|.....|....|..#############
#############..|.....|..........|..#############
#############..|.....|..........|..#############
#############..|.....|..........|..#############
#############..|.....|..........|..#############
#############..|................|..#############
#############..|................|..#############
#############..|................|..#############
#############..|................|..#############
#############..|................|..#############
###########=...|................|...=###########
#############..|................|..#############
#################..............#################
#############..|................|..#############
#############..|................|..#############
#############..|................|..#############
#############...................|..#############
#############...................|..#############
#############...................|..#############
#############...................|..#############
#############...................|..#############
#############...................|..#############
#############..|................|..#############
#############..|................|..#############
###########=...|................|..#############
#############..|................|..#############
#################..............#################
#############..|................|..#############
#############..|...................#############
#############..|...................#############
#############..|...................#############
#############..|...................#############
#############..|...................#############
#############..|...................#############
#############..|...................#############
#############..|...................#############
###########=...|...................#############
#############..|...................#############
###########=...|....................=###########
#############..|...................#############
#################..............#################
#############......................#############
#############......................#############
#############......................#############
#############......................#############
#############......................#############
#############......................#############
#############......................#############
#############......................#############
#############......................#############
#############......................#############
#############......................#############
#############......................#############
#############......................#############
#############......................#############
#############......................#############
#############......................#############
#############......................#############
#############......................#############
#############......................#############
#############......................#############
#############......................#############
#############......................#############
#############......................#############
#############......................#############
#############......................#############
#############......................#############
#############......................#############
#############......................#############
#############......................#############
#############......................#############
#############......................#############
#############......................#############
#############......................#############
#############......................#############
#############......................#############
#############......................#############
#############......................#############
#############......................#############
#############......................#############
#############......................#############
#############......................#############
#############......................#############
#############......................#############
#############......................#############
#############......................#############
#############......................#############
#############......................#############
#############......................#############
#############......................#############
#############......................#############
#############......................#############
#############......................#############
#############......................#############
#############......................#############
#############......................#############
#############......................#############
#############......................#############
#############......................#############
#############......................#############
#############......................#############
#############......................#############
#############......................#############
#############......................#############
#############......................#############
#############......................#############
#############......................#############
#############......................#############
#############......................#############
#############......................#############
#############......................#############
#############......................#############
#############......................#############
#############......................#############
#############......................#############
####=....=###..............................=####
######..#####...................########..######
######..####/....................../####..######
######--###/......................../###--######
######..##/........................../##..######
######..#/............................/#..######
######--#..............................#--######
######..#..............................#..######
######..#..............................#..######
######--#..............................#--######
####/#..#..............................#..#/####
#....#..#..............................#..#.####
#....#--#..............................#--#.####
#....|..|...................................####
#....|..|...................................####
#....+-.+...................................####
#....|..|...................................####
#....|..|...................................####
#....+..|.............................#......=##
#....|................................#.....####
##...|................................#......=##
###....##.............................#.....####
#########...........................############
#########...........................############
#########...........................############
#########...........................############
####..#...............................#.....####
####..#...............................#.....####
####..#...............................#.....####
####..#...............................#.....####
####..#...............................#.....####
####..................................#.....####
####..................................#.....####
####..................................#.....####
####..................................#.....####
####........................................####
###/......................................../###
##/........................................../##
#/............................................/#
#..............................................#
#..............................................#
#..............................................#
#..............................................#
#..............................................#
#..............................................#
#..............................................#
#..............................................#
#.............................................##
#.............................................##
#.............................................##
##.#/....................................../#.##
##=##/..................................../##=##
######/................................../######
#######/................................/#######
########/............................../########
#########/............................/#########
##########/........................../##########
###########/......................../###########
############/....................../############
#############...###..........###...#############
#############...###..........###...#############
#############...###..........###...#############
#############...###..........###...#############
#############...###..........###...#############
#############...###..........###...#############
##############.####..........####.##############
##############=####..........####=##############
###################..........###################
###################..........###################
###################..........###################
###################..........###################
###################..........###################
###################..........###################
###################..........###################
###################..........###################
###################..........###################
###################..........###################
###################..........###################
###################..........###################
###################..........###################
###################..........###################
###################..........###################
###################..........###################
###################..........###################
###################..........###################
###################..........###################
###################..........###################
19,2|18,2|20,2|23,2|25,2|24,2|26,2|29,2|30,2|17,4|19,4|18,4|20,4|23,4|25,4|24,4|26,4|29,4|30,4|14,4|13,5|35,5|34,4|13,15|35,15|13,16|35,16|13,18|13,17|17,18|17,17|31,18|31,17|35,18|35,17|13,29|13,30|13,32|13,31|17,32|17,31|31,32|31,31|35,32|35,31|13,41|13,43|13,42|35,43|13,44|35,44|13,46|13,45|17,46|17,45|31,46|31,45|35,46|35,45|35,120|6,121|8,121|32,122|32,121|40,121|42,121|13,122|35,122|9,126|39,126|1,131|5,131|4,130|44,131|43,130|39,133|43,133|44,138|39,138|38,138|44,140|44,139|1,140|2,140|2,141|3,141|7,141|9,141|44,141|3,142|7,142|36,142|39,142|38,142|44,142|4,146|7,146|6,146|9,146|36,146|39,146|38,146|44,146|7,151|6,151|39,155|38,155|4,156|44,156|1,159|47,159|46,167|47,167|1,170|2,170|3,170|4,170|44,170|45,170|13,179|35,179|16,179|19,179|29,179|32,179|13,185|14,185|15,185|16,185|32,185|33,185|34,185|35,185|