Pièce : SL_H03
taille : 444x38
..........................................................................................................................................................................................................................................................................................................................................................................................................................................##################
..........................................................................................................................................................................................................................................................................................................................................................................................................................................##################
..........................................................................................................................................................................................................................................................................................................................................................................................................................................##################
..........................................................................................................................................##..............................................................................................................................................................................................................................................................................................##################
..........................................................................................................................................##...........###................................................................................................................................................................................................................................................................................##################
.........................................................................................................................................##########HH######...............................................................................................................................................................................................................................................................................##################
.........................................................................................................................................######=###..######..............................................................................................................................................................................................................................................................................###################
.......................................................................................................................................--##########--######--............................................................................................................................................................................................................................................................................###################
..........................................................................................................................................#########..######..............................................................................................................................................................................................................................................................................###################
...........................................................................................................................................####...#..#..###..............................................................................................................................................................................................................................................................................###################
..................................................................................................................................................#--#...................................................................................................................................................................................................................................................................................###################
..................................................................................................................................................#..#...................................................................................................................................................................................................................................................................................###################
..................................................................................................................................................#..#..................................................................................................................................................................................................................................................................................####################
..................................................................................................................................................#--#..................................................................................................................................................................................................................................................................................####################
..................................................................................................................................................|..|..........|..|.....................................................................................................................................................................................................................................................................=##################
.....................................................................................................................................................|..........####....................................................................................................................................................................................................................................................................####################
.............................................................|......................................................................................-+........../##/...................................................................................................................................................................................................................................................................#####################
.............................................................|..|....................................................................................|..........|##|.................................................................................................................................................................................................................................................................#######################
......................................................|......####...............................................................................................|..|............................................................................................................................................................................................................................................../#########################################
...................................................|..|....../##/...............................................................................................|..|..............................................................................................................................................................................................................................................##########################################
...................................................####......|##|................................................................................######.........|..|..............................................................................................................................................................................................................................................##########################################
.................................................../##/......|..|............................................................................############.......|..|..............................................................................................................................................................................................................................................##########################################
...................................................|##|......|..|........................................................................##################.....|..|..............................................................................................................................................................................................................................................##########################################
...................................................|..|......|..|......................................................................######################...|..|..............................................................................................................................................................................................................................................##########################################
...................................................|..|......|..|....................................................................##########################.|..|..............................................................................................................................................................................................................................................##########################################
.....................................####..........|..|......|..|.................................................................##############################|..|............................................................................................................................................................................................................................................../#########################################
.....................................#=##..........|..|......|..|...............................................................###################################|...................................................................................................................................................................................................................................................................#####################
.....................................####..........|..|......|..|.............................................................########################################................................................................................................................................................................................................................................................................######################
.....................................####..........|..|.####.|..|.........................................................#################################################...........................................................................................................................................................................................................................................................######################
.....................................####..........|..|.#=##.|..|.....................................................########################################################.........................................................................................##.###..........................................................................................................................................................=####################
.....................................####..........|..|.####.|..|..................................................###############################################################..................................................................................#####=######......................................................................................................................................................######################
.....................................####.##.......#..|.####.|..|.............................................#######################################################################.####.......................................................................#################...................................................................................................................................................#######################
.....................................########....###..|.####.|..#.....#####.########....................###.#########################################################################=##########..............................##########......................#########################.............................................................................................................................................########################
..........................#############################.####.##############=###########.......#############=############################################################################################..................###################..........#############################################................................................................................................................................########################
....#########################=##########################################################################################################################################################################################################################################################################...........................................................................................................................#########################
#####################=######################################################################################################################################################################################################################################################################################......................................................................................................................##########################
#################################################################################################################################################################################################################################################################################################################................................................................................................................###########################
####################################################################################################################################################################################################################################################################################################################.............................................................................................................###########################
(4,34),(4,35)|(21,35),(21,36)|(22,35),(22,36)|(26,33),(26,34)|(29,34),(29,35)|(30,34),(30,35)|(37,25),(37,33)|(38,26),(38,27)|(39,26),(39,27)|(41,25),(41,32)|(42,31),(42,32)|(44,31),(44,32)|(45,32),(45,33)|(49,32),(49,33)|(51,20),(51,21)|(51,31),(51,32)|(52,23),(52,31)|(55,20),(55,21)|(55,33),(55,34)|(56,28),(56,34)|(57,29),(57,30)|(58,29),(58,30)|(60,28),(60,34)|(61,18),(61,19)|(61,33),(61,34)|(64,21),(64,32)|(65,18),(65,19)|(65,32),(65,33)|(70,32),(70,33)|(75,32),(75,34)|(76,32),(76,34)|(84,32),(84,33)|(87,33),(87,34)|(94,33),(94,34)|(104,32),(104,33)|(107,32),(107,34)|(108,32),(108,34)|(110,31),(110,32)|(115,30),(115,31)|(118,29),(118,30)|(122,28),(122,29)|(126,27),(126,28)|(128,26),(128,27)|(130,25),(130,26)|(133,24),(133,25)|(135,23),(135,24)|(137,5),(137,8)|(137,22),(137,23)|(138,3),(138,5)|(138,8),(138,9)|(139,9),(139,10)|(140,3),(140,5)|(141,21),(141,22)|(143,6),(143,7)|(143,9),(143,10)|(144,6),(144,7)|(145,20),(145,21)|(146,9),(146,14)|(147,5),(147,14)|(149,5),(149,14)|(150,9),(150,14)|(151,4),(151,5)|(151,20),(151,21)|(152,9),(152,10)|(153,21),(153,22)|(154,4),(154,5)|(155,5),(155,10)|(155,22),(155,23)|(157,23),(157,24)|(159,24),(159,25)|(160,15),(160,16)|(160,25),(160,26)|(163,18),(163,26)|(164,15),(164,16)|(166,27),(166,28)|(171,28),(171,29)|(174,29),(174,30)|(178,30),(178,31)|(181,31),(181,33)|(182,31),(182,33)|(186,31),(186,32)|(192,32),(192,33)|(200,33),(200,34)|(218,33),(218,34)|(222,32),(222,33)|(232,32),(232,33)|(237,33),(237,34)|(247,33),(247,34)|(254,32),(254,33)|(257,31),(257,32)|(260,30),(260,31)|(263,29),(263,30)|(265,29),(265,31)|(266,29),(266,31)|(269,29),(269,30)|(272,30),(272,31)|(274,31),(274,32)|(279,32),(279,33)|(292,33),(292,34)|(296,34),(296,35)|(300,35),(300,36)|(305,36),(305,37)|(308,37),(308,38)|(402,19),(402,25)|(417,36),(417,38)|(418,35),(418,36)|(419,34),(419,35)|(420,32),(420,34)|(421,17),(421,18)|(421,31),(421,32)|(422,27),(422,29)|(422,30),(422,31)|(423,16),(423,17)|(423,26),(423,27)|(424,12),(424,14)|(424,15),(424,16)|(424,29),(424,30)|(425,6),(425,12)|(426,0),(426,6)|(426,14),(426,15)|
(138,3),(140,3)|(151,4),(154,4)|(137,5),(138,5)|(140,5),(147,5)|(149,5),(151,5)|(154,5),(155,5)|(143,6),(144,6)|(425,6),(426,6)|(143,7),(144,7)|(137,8),(138,8)|(138,9),(139,9)|(143,9),(146,9)|(150,9),(152,9)|(139,10),(143,10)|(152,10),(155,10)|(424,12),(425,12)|(146,14),(147,14)|(149,14),(150,14)|(424,14),(426,14)|(160,15),(164,15)|(424,15),(426,15)|(423,16),(424,16)|(421,17),(423,17)|(61,18),(65,18)|(161,18),(163,18)|(403,18),(421,18)|(51,20),(55,20)|(145,20),(151,20)|(62,21),(64,21)|(141,21),(145,21)|(151,21),(153,21)|(137,22),(141,22)|(153,22),(155,22)|(52,23),(54,23)|(135,23),(137,23)|(155,23),(157,23)|(133,24),(135,24)|(157,24),(159,24)|(37,25),(41,25)|(130,25),(133,25)|(159,25),(160,25)|(38,26),(39,26)|(128,26),(130,26)|(160,26),(163,26)|(403,26),(423,26)|(38,27),(39,27)|(126,27),(128,27)|(163,27),(166,27)|(422,27),(423,27)|(56,28),(60,28)|(122,28),(126,28)|(166,28),(171,28)|(57,29),(58,29)|(118,29),(122,29)|(171,29),(174,29)|(263,29),(265,29)|(266,29),(269,29)|(422,29),(424,29)|(57,30),(58,30)|(115,30),(118,30)|(174,30),(178,30)|(260,30),(263,30)|(269,30),(272,30)|(422,30),(424,30)|(42,31),(44,31)|(51,31),(52,31)|(110,31),(115,31)|(178,31),(181,31)|(182,31),(186,31)|(257,31),(260,31)|(265,31),(266,31)|(272,31),(274,31)|(421,31),(422,31)|(41,32),(42,32)|(44,32),(45,32)|(49,32),(51,32)|(64,32),(65,32)|(70,32),(75,32)|(76,32),(84,32)|(104,32),(107,32)|(108,32),(110,32)|(186,32),(192,32)|(222,32),(232,32)|(254,32),(257,32)|(274,32),(279,32)|(420,32),(421,32)|(26,33),(37,33)|(45,33),(49,33)|(52,33),(55,33)|(61,33),(64,33)|(65,33),(70,33)|(84,33),(87,33)|(94,33),(104,33)|(181,33),(182,33)|(192,33),(200,33)|(218,33),(222,33)|(232,33),(237,33)|(247,33),(254,33)|(279,33),(292,33)|(4,34),(26,34)|(29,34),(30,34)|(55,34),(56,34)|(60,34),(61,34)|(75,34),(76,34)|(87,34),(94,34)|(107,34),(108,34)|(200,34),(218,34)|(237,34),(247,34)|(292,34),(296,34)|(419,34),(420,34)|(0,35),(4,35)|(21,35),(22,35)|(29,35),(30,35)|(296,35),(300,35)|(418,35),(419,35)|(21,36),(22,36)|(300,36),(305,36)|(417,36),(418,36)|(305,37),(308,37)|(308,38),(417,38)|
(51,21),(52,22)|(61,19),(62,20)|(160,16),(161,17)|(402,25),(403,26)|
(54,22),(55,21)|(64,20),(65,19)|(163,17),(164,16)|(402,19),(403,18)|
(51.5,19),(51.5,20)|(51.5,22),(51.5,31)|(54.5,18),(54.5,20)|(54.5,22),(54.5,33)|(61.5,16),(61.5,18)|(61.5,20),(61.5,33)|(64.5,17),(64.5,18)|(64.5,20),(64.5,32)|(146.5,14),(146.5,15)|(149.5,14),(149.5,18)|(160.5,14),(160.5,15)|(160.5,17),(160.5,26)|(163.5,14),(163.5,15)|(163.5,17),(163.5,27)|
(135,7.5),(137,7.5)|(147,7.5),(147,10.5)|(147,13.5),(148,16.5)|(149,7.5),(149,10.5)|(149,13.5),(155,7.5)|
end file : SL_H03